WWWWWWWWWWWWWWWWWWWWWWWWWWWWWWWWWWWWWWWWWWWWWWWWWWWWWWWWWWWWWWWWWWWWWWWWWWWWWWWWWWWWWWWWWWWWWWWWWWWWWWWWWWWWWWWWWWWWWWWWWWWWWWWWWW
W--WLevel1--------------------------------------------W---W----------------------------------------------------------------------W
W----------------------------------------------------W-----W---------------------------------------------------WWWWWWWWWWWWWWWWW-W
W---------------------------------------W-----------W-------W-------------------------------------------------W----------------W-W
W----------W------------W--------------W-W---------W---------W------------------------------------------------WWWWWWWWWWWWWWWW-W-W
W---------WWW----------W-W------------W---W--------W----------W---------------------------WWWWWWWWWWWW-----------------------W-W-W
W--------WWWWW--------W---W----------W-----W-------W---------W----------------------------W----------W-WWWWWWWWWWWWWWWWWWWW--W-W-W
W------------WW------W-----W--------W-------W-------W-------W-----------------------------W-WWWWWWWW-W-W------------------W--W-W-W
W------WWW---WWW----W-------W------W---------W-------------W------WWWWWWWWWWW-------------W-W-W----W-W-W-WWWWWWWWWWWWWWWW-W--W-W-W
W-----WWWW-W--WWW--W---------W----W-----------W-----------W------------------W------------W-W-W-WW-W-W-W-W--------------W-W--W-W-W
W-----WWWW----WWWWW-----------W--W-------------W---------W--------------------W-----------W-W-W-WW-W-W-W-W--------------W-W--W-W-W
W------WWWWWW-WWW--------------WW---------------W-------W-----WWW--------------W----------W-W-W-WW-W-W-W-W--------------W-W--W-W-W
W-------WWWWW------W-----------------------------W-----W-----W---W--------------W---------W-W-W-WW-W-W-W-W--------------W-W--W-W-W
W--------WWWWWWWW-W-W---------W-------------------W---W-------W---W--------------W--------W-W-W-WW-WWW-W-W--------------W-W--W-W-W
W---------WWWWWWWW---W-------W-W------W------------W---W-------W---W--------------W-------W-W-W--------W-W--------------W-W--W-W-W
W----------WWWWWW-----W-----W---W----W-W------------W---W-------W---W--------------W------W-W-WWWWW-WWWW-WWWWWWWWWWWWWWWW-W--W-W-W
W-----------WWWW-------W---W-----W--W---W------------W---W-----W-----W--------------W-----W-W-----W--W--------------------W--W-W-W
W------------WW---------WWW-------WW-----W------------W---W---W----WWWW--------------W----W-WWWWWWW--W-W-WWWWWWWWWWWWWWWWWW--W-W-W
W-----------------------------------------W------------W---WWW----W-------------------W---W----------W-W---------------------W-W-W
W------------------------------------------W------------W--------W---------------------W--WWWWWWWWWWWW-WWWWWWWWWWWWWWWWWWWWWWW-W-W
W-------------------------------------------W------------W------W-----------------------W--------------------------------------W-W
WWWWWWWWWWWWWWWWWWWWWWWWWWWWWWWWWWWWWWWWWWWWWW------------W--WWW-------------------------WWWWWWWWWWWWWWWWWWWWWWWWWWWWWWWWWWWWWWW-W
W----------------------------------------------------------WW--------------------------------------------------------------------W
W--------------------------------------------------------------------------------------------------------------------------------W
WWWWWWWWWWWWWWWWWWWWWWWWWWWWWWWWWWWWWWWWWWWWWWWWWWWWWWWWWWWWWWWWWWWWWWWWWWWWWWWWWWWWWWWWWWWWWWWWWWWWWWWWWWWWWWWWWWWWWWWWWWWWWWWWWW
