WWWWWWWWWWWWWWWWWWWWWWWWWWWWWWWWWWWWWWWWWWWWWWWWWWWWWWWWWWWWWWWWWWWWWWWWWWWWWWWWWWWWWWWWWWWWWWWWWWWWWWWWWWWWWWWWWWWWWWWWWWWWWWWWWW
W------------------------+-------W---------------WWWWW----------------------------W----W------WWWWW------------------------------W
W-WWWWW-WWW-WWWW-WW--WWW------------W-------WWWWWWWW-WWWWWWWWWWWWWWWWWWWWWWWWWWWWW-W---WWWWWWW-----W--WWWWWWWWWWWWWWWWWWWWWWWWWW-W
W-W--------------------W--W----W---W-W------W----W--------------------------------W-WWWWWWWWWWWWW--W--W-WWWW---WWWWW-----------W-W
W-W-WWWWWWWWWWWWWWWWWWWW-WW--W-W--W---W-----W--WWWWWWWW--------------WWWWWWWW-----W--------------W-W--W-W--W---W---W-WWWWWWWWW-W-W
W-W-W------------------------W-W-------W----W--W-W-----WWWWWWWWW----W--------WWWWWWWWWWW-WWWWWWW-W-W--W-W--W---W---W-W-W--W--W-W-W
W-W-W-WWWWWWWWW-WWWWWWWW-WWWWW-W--------W---W--W-W--------------WWWWWWWWWW-----------W---------W-W-W--W-W--WWWWW---W-W-W--W--W-W-W
W-W-W-W------------------------W---------W--W--W-W----------------W------W----------W-W--------W-W-W--W-W------------W-W--W--W-W-W
W-W-W-W-WWWWWWWWWWWWWWW-WWW-WWWWW-----------W--WWW----WW---------W-------W---------W---W-------W-W-W--W-W-WWWWWWWW-W-W-W--W--W-W-W
W-W-W-W-WWWWWW--W--------------W-W--------WWWWWWWW---W--W--------W-------W--------W-----W------W-W--W-W-W-W------W-W-W-W--W--W-W-W
W-W-W-W------W--W-WWWWW--------W--W-------W-W----WW--W---W--------WWWWWWW--------W-------W-----W-WW-W-W-W-WWWWWW-W-W-W----W--W-W-W
W-W-W-WWWWW--W--W-W---W--------W---W--W---W-W----WW--W----WW-------W------------W---------W----W--W-W-W-W-WW---W-W-W-W-WWWW--W-W-W
W-W-W-----W--W--W-W---WW-------W----W-W---W-WWWWWWW--W-----W-----W--W----------W-----------W---W--W-W-W---WW---W-WWW-W-------W-W-W
W-W-W-WWW-W--WW-W-W--W-W-------W-----WW---W------W---W------W----W--W--------WWWWWWW--WWWWWWW--W--W-W-WW--WW---W-W---WWWWWWW-W-W-W
W-W-W-W-W-W---W-W-W--W-W--------------W---WWWWWWWWWWWW-------W---W-----------W-----W--W--------W--W-W--W--WW---W-W-----------W-W-W
W-W-W-W-W-WWW-W-W-W--W-W--------------WW---------W------------W--W----------W------W--W--------W--W-W--W--WW-----W-----------W-W-W
W-W-W-W-W---W-W-W-W--W-W---------------WWWWWWWWWWWWWWWWWWW----W-WWWWWWWWWWWW-------W--W--WWWWWWW--W-W--W--WW-----WWWWWWWWWWWWW-W-W
W-W-W-W-WWW-W-----W----W-----------------W-----WWWWWWWW---WWWW---W-----------------W--W--W--------W-W--W--WWWW---W-------------W-W
W-W-W-W---W-WWW-W-WWWW---WW---------------W---WWWWW------WWWW----------------------W--W--W-WWWWWWWW-W--WW-W---W----WWWWWWWWWW--W-W
W-W-W-WWW-W---W-W------W-------------------W--W--W-W----W-------W-------WWWWWWWWW--W--W--W-W--------W---W-W---W--W----------W--W-W
W-W-WWWWW-WWWWW-WWWWWWWW--------------------W-W--W-WWWWW-------W----------------W--WWWW--W-W--------W---W-W---W--WWWWWWWWWWWW--W-W
W-W------------------------------------------WWWWWWWWWWWWWWWWWWWWWWWWWW---------WWWWWWWWWW-W-------W----W-W---W--W-------------W-W
W-WWWWWWWWWWWWWWWWWWWWWWWWWWWWWWWWWWWWWWWWWWW----W------W--------------W-------------------W--WWWWWWWWWWW-W---W--W-WWWWWWWWWWWWW-W
W------------------------------------------------W-----W----------------WWWWWWWWWWWWWWWWWWWW--------------W--WW--W---------------W
WWWWWWWWWWWWWWWWWWWWWWWWWWWWWWWWWWWWWWWWWWWWWWWWWWWWWWWWWWWWWWWWWWWWWWWWWWWWWWWWWWWWWWWWWWWWWWWWWWWWWWWWWWWWWWWWWWWWWWWWWWWWWWWWWW
