WWWWWWWWWWWWWWWWWWWWWWWWWWWWWWWWWWWWWWW+WWWWWWWWWWWWWWWWWWWWWWWWWWWWWWWWWWWWWWWW
W------------------------------------------------------------------------------W
W------------------------------------------------------------------------------W
W------------------------------------------------------------------------------W
W------------------------------------------------------------------------------W
W------------------------------------------------------------------------------W
W------------------------------------------------------------------------------W
W------------------------------------------------------------------------------W
W------------------------------------------------------------------------------W
W------------------------------------------------------------------------------W
W------------------------------------------------------------------------------W
W------------------------------------------------------------------------------W
W------------------------------------------------------------------------------W
W------------------------------------------------------------------------------W
W------------------------------------------------------------------------------W
W------------------------------------------------------------------------------W
W------------------------------------------------------------------------------W
W------------------------------------------------------------------------------W
W------------------------------------------------------------------------------W
W------------------------------------------------------------------------------W
W------------------------------------------------------------------------------W
W------------------------------------------------------------------------------W
W------------------------------------------------------------------------------W
WWWWWWWWWWWWWWWWWWWWWWWWWWWWWWWWWWWWWWWWWWWWWWWWWWWWWWWWWWWWWWWWWWWWWWWWWWWWWWWW
