WWWWWWWWWWWWWWWWWWWWWWWWWWWWWWWWWWWWWWWWWWWWWWWWWWWWWWWWWWWWWWWWWWWWWWWWWWWWWWWWWWWWWWWWWWWWWWWWWWWWWWWWWWWWWWWWWWWWWWWWWWWWWWWWWW
W--WLevel1-----------------------------------------------------------------------------------------------------------------------W
W----WWWWWWWWWWWWW---------------------------------------------------------------------------------------------------------------W
W----W-----------W---------------------------------------------------------------------------------------------------------------W
W----W-----------W------------------------WWWWWW---------------------------------------------------------------------------------W
W----W-----------W------------------------W+---W---------------------------------------------------------------------------------W
W----W-----------WW-----------------------W----WWWWWW----------------------------------------------------------------------------W
W----W-------------W----------------------W---------W----------------------------------------------------------------------------W
W----W--------------W---------------------WWWWWW----W----------------------------------------------------------------------------W
W----W---------------W-------------------------W----W----------------------------------------------------------------------------W
W----W----------------W------------------------WWWW-WWWWW-WWW-------------------WWWWWWWWWWWWWWWWWWWWW----------------------------W
W----W-----------------W--------------------------W---------W-------------------W-------------------W----------------------------W
W----WWWWWWWWW----------W-------------------------W---------W-------------------W-------------------W----------------------------W
W------------W------WWW--W------------------------W---------W-------------------W-------------------W----------------------------W
W------------W------W-----WWWWWWWWWWWWWWWWWWWWWWWWW---WWW---W-------------------W-------------------W----------------------------W
W------------W------W---------------------------------W-W----WWWWW-WWWWWWWWWWWWWW-------------------W----------------------------W
W------------W------W---------------------------------W-W--------W-W--------------------------------W----------------------------W
W------------W------WWWWWWWW--------------------------W-W--------W-W--------------------------------W----------------------------W
W----WWWWWWWWWWWWWWWW------W--------------------------W-W--------W-W------------WWWWWWWWWWWWWWWWWWWWW----------------------------W
W--------------------------WWWWWWWWWWWWWWWWWWWWWWWWWWWW-W-----------------------W------------------------------------------------W
W-------------------------------------------------------W-----------------------W------------------------------------------------W
W-------------------------------------------------------WWWWWWWWWWWWWWWWWWWWWWWWW------------------------------------------------W
W--------------------------------------------------------------------------------------------------------------------------------W
W--------------------------------------------------------------------------------------------------------------------------------W
WWWWWWWWWWWWWWWWWWWWWWWWWWWWWWWWWWWWWWWWWWWWWWWWWWWWWWWWWWWWWWWWWWWWWWWWWWWWWWWWWWWWWWWWWWWWWWWWWWWWWWWWWWWWWWWWWWWWWWWWWWWWWWWWWW
