WWWWWWWWWWWWWWWWWWWWWWWWWWWWWWWWWWWWWWWWWWWWWWWWWWWWWWWWWWWWWWWWWWWWWWWWWWWWWWWW
W                                                                              W
W                                                                              W
W                                                                              W
W                                                     WWWWWW                   W
W                                                     WWWWWW                   W
W                                                                              W
W                          wwwwww                                              W
W                               w                                              W
W                   WWWWWWWWW   w                                              W
W                     w         w         WWWWWWW                              W
W                     w  w      w                                              W
W                     w  wwwwwwww                                              W
W                     w                                                        W
W                     wwwwwwwwwwwwwwwwwwww                                     W
W                                                                              W
W                                                                              W
W                              WWWWWWWWWWWWWWWWWWWW                            W
W                                                                              W
W                                                                              W
W                                                                              W
W                                                                              W
W                                                                              W
WWWWWWWWWWWWWWWWWWWWWWWWWWWWWWWWWWWWWWWWWWWWWWWWWWWWWWWWWWWWWWWWWWWWWWWWWWWWWWWW