WWWWWWWWWWWWWWWWWWWWWWWWWWWWWWWWWWWWWWWWWWWWWWWWWWWWWWWWWWWWWWWWWWWWWWWWWWWWWWWWWWWWWWWWWWWWWWWWWWWWWWWWWWWWWWWWWWWWWWWWWWWWWWWWWW
W--------------------------------------------------------------------------------------------------------------------------------W
W----------------W-------+---WWWWWW----------------------------------------------------------------------------------------------W
W-W-W------------W---W-W--------W------------------------------------------------------------------------------------------------W
W-W-W-WWWWWWWWWWWWWW-W-W------WWWWWWWW----W--------------------------------------------------------------------------------------W
W-W-W--W-W---W-W-W---W-W-WW-------W----------------------------------------------------------------------------------------------W
W-W-W--W-W---W-W-WWWWW-W--W--------W---------------------------------------------------------------------------------------------W
W-W-W--W-----W-W-W-W-W-WW-W-----W---W--------------------------------------------------------------------------------------------W
W-W-W--W--W--W-W-W-W-W-W--W-W-W-W----W-------------------------------------------------------------------------------------------W
W-W-W-----W--W-W-W-W-W-W----W---W--W--WW-----------------------------------------------------------------------------------------W
W-W-WWWWWWWWWW-W-W-W-W-WWWWWWWWWW--W---W-----------------------------------------------------------------------------------------W
W-W------W-W---W-W-W-W-W-----------W---W-----------------------------------------------------------------------------------------W
W-WWWWWW-W-W-W-W-W-W-W-W-WWWWWWWWWWWW--W-----------------------------------------------------------------------------------------W
W-W--W-W-W-W-W-W-W-W-W-W-W-W---W---W---W------------------W----------------------------------------------------------------------W
W-WW-W-W-W---W-W-W-W-W-W-W---W---W---W-W------------------W----------------------------------------------------------------------W
W-W--W-W-WWW-W-W-W-W-W-W-WWWWWWWWWWWWWWW-----------------------------------------------------------------------------------------W
W-W-WW-W-W---W-W-W-W-W-W----------------------------------W----------------------------------------------------------------------W
W-W--W-W-W---W-W-W-W-W-W---------------------------------------------------------------------------------------------------------W
W-WW-W-W-WWW-W-W-W-W-W-W---------------------------------------------------------------------------------------------------------W
W-W--W-W-----W-W-W-W-W-W---------------------------------------------------------------------------------------------------------W
W-W-WW-WWWWWWW-W-W-W-W-W---------------------------------------------------------------------------------------------------------W
W-W--------------W---W-W---------------------------------------------------------------------------------------------------------W
W-WWWWWWWWWWWWWWWWWWWW-W---------------------------------------------------------------------------------------------------------W
W----------------------W---------------------------------------------------------------------------------------------------------W
WWWWWWWWWWWWWWWWWWWWWWWWWWWWWWWWWWWWWWWWWWWWWWWWWWWWWWWWWWWWWWWWWWWWWWWWWWWWWWWWWWWWWWWWWWWWWWWWWWWWWWWWWWWWWWWWWWWWWWWWWWWWWWWWWW
