WWWWWWWWWWWWWWWWWWWWWWWWWWWWWWWWWWWWWWWWWWWWWWWWWWWWWWWWWWWWWWWWWWWWWWWWWWWWWWWW
W--WLevel4---------------------------------------------------------------------W
W--W---------------------------------------------------------------------------W
W--W---------------------------------------------------------------------------W
W--W---------------------------------------------------------------------------W
W--W---------------------------------------------------------------------------W
W--W---------------------------------------------------------------------------W
W--W---------------------------------------------------------------------------W
W--W---------------------------------------------------------------------------W
W--W---------------------------------------------------------------------------W
W--W---------------------------------------------------------------------------W
W------------------------------------------------------------------------------W
W------------------------------------------------------------------------------W
W------------------------------------------------------------------------------W
W------------------------------------------------------------------------------W
W------------------------------------------------------------------------------W
W------------------------------------------------------------------------------W
W------------------------------------------------------------------------------W
W------------------------------------------------------------------------------W
W------------------------------------------------------------------------------W
W------------------------------------------------------------------------------W
W------------------------------------------------------------------------------W
W------------------------------------------------------------------------------W
WWWWWWWWWWWWWWWWWWWWWWWWWWWWWWWWWWWWWWWWWWWWWWWWWWWWWWWWWWWWWWWWWWWWWWWWWWWWWWWW
