WWWWWWWWWWWWWWWWWWWWWWWWWWWWWWWWWWWWWWWWWWWWWWWWWWWWWWWWWWWWWWWWWWWWWWWWWWWWWWWWWWWWWWWWWWWWWWWWWWWWWWWWWWWWWWWWWWWWWWWWWWWWWWWWWW
W--WLevel5-----------------------------------------------------------------------------------------------------------------------W
W--------------------------------------------------------------------------------------------------------------------------------W
W------+-------------------------------------------------------------------------------------------------------------------------W
W-------+------------------------------------------------------------------------------------------------------------------------W
W--------+------------------++---------------------------------------------------------------------------------------------------W
W---------+----------------+--+--------------------------------------------------------------------------------------------------W
W----------+--------------+----+-------------------------------------------------------------------------------------------------W
W-----------+------------+------+------------------------------------------------------------------------------------------------W
W------------+----------+--------+-----------------------------------------------------------------------------------------------W
W-------------+--------+----------+----------------------------------------------------------------------------------------------W
W--------------+------+----------------------------------------------------------------------------------------------------------W
W---------------+----+-----------------------------------------------------------------------------------------------------------W
W----------------+--+------------------------------------------------------------------------------------------------------------W
W-----------------++-------------------------------------------------------------------------------------------------------------W
W--------------------------------------------------------------------------------------------------------------------------------W
W--------------------------------------------------------------------------------------------------------------------------------W
W--------------------------------------------------------------------------------------------------------------------------------W
W--------------------------------------------------------------------------------------------------------------------------------W
W--------------------------------------------------------------------------------------------------------------------------------W
W--------------------------------------------------------------------------------------------------------------------------------W
W--------------------------------------------------------------------------------------------------------------------------------W
W--------------------------------------------------------------------------------------------------------------------------------W
W--------------------------------------------------------------------------------------------------------------------------------W
WWWWWWWWWWWWWWWWWWWWWWWWWWWWWWWWWWWWWWWWWWWWWWWWWWWWWWWWWWWWWWWWWWWWWWWWWWWWWWWWWWWWWWWWWWWWWWWWWWWWWWWWWWWWWWWWWWWWWWWWWWWWWWWWWW
