WWWWWWWWWWWWWWWWWWWWWWWWWWWWWWWWWWWWWWWWWWWWWWWWWWWWWWWWWWWWWWWWWWWWWWWWWWWWWWWW
W------------------------------------------------------------------------------W
W-W----W---W---WW--------------------------------------------------------------W
W-W-----W-W---WWW--------------------------------------------------------------W
W-W-----W-W-----W--------------------------------------------------------------W
W-WWWW---W---WWWWWWW-----------------------------------------------------------W
W------------------------------------------------------------------------------W
W------------------------------------------------------------------------------W
W------------------------------------------------------------------------------W
W------------------------------------------------------------------------------W
W------------------------------------------------------------------------------W
W------------------------------------------------------------------------------W
W------------------------------------------------------------------------------W
W------------------------------------------------------------------------------W
W------------------------------------------------------------------------------W
W------------------------------------------------------------------------------W
W------------------------------------------------------------------------------W
W------------------------------------------------------------------------------W
W------------------------------------------------------------------------------W
W------------------------------------------------------------------------------W
W------------------------------------------------------------------------------W
W------------------------------------------------------------------------------W
W------------------------------------------------------------------------------W
W------------------------------------------------------------------------------W
WWWWWWWWWWWWWWWWWWWWWWWWWWWWWWWWWWWWWWWWWWWWWWWWWWWWWWWWWWWWWWWWWWWWWWWWWWWWWWWW
