WWWWWWWWWWWWWWWWWWWWWWWWWWWWWWWWWWWWWWWWWWWWWWWWWWWWWWWWWWWWWWWWWWWWWWWWWWWWWWWW
W---W--------------------------------------------------------------------------D
W---W-----"Your-Task-Is-Simple,-just-get-from-the-one-end-to-another"----------D
W---W--------------------------------------------------------------------------D
W---W--------------------------------------------------------------------------D
W---WWWWW----------------------------------------------------------------------D
W------WW----------------------------------------------------------------------W
W------WW----------------------------------------------------------------------W
W------WW----------------------------------------------------------------------W
W------WW----------------------------------------------------------------------W
W------WW----------------------------------------------------------------------W
W---WWWWW----------------------------------------------------------------------W
W------------------------------------------------------------------------------W
W------------------------------------------------------------------------------W
W------------------------------------------------------------------------------W
WDDDDDDDWW---------------------------------------------------------------------W
W-------WW---------------------------------------------------------------------W
W-------WW---------------------------------------------------------------------W
W-------WW---------------------------------------------------------------------W
W-----*-WW------------------------------------------------------------WWWWWWWWWW
WWWWWWWWWW------------------------------------------------------------W-------*W
W---------------------------------------------------------------------W-------*W
T---------------------------------------------------------------------D-------*W
WWWWWWWWWWWWWWWWWWWWWWWWWWWWWWWWWWWWWWWWWWWWWWWWWWWWWWWWWWWWWWWWWWWWWWWWWWWWWWWW
