WWWWWWWWWWWWWWWWWWWWWWWWWWWWWWWWWWWWWWWWWWWWWWWWWWWWWWWWWWWWWWWWWWWWWWWWWWWWWWWWWWWWWWWWWWWWWWWWWWWWWWWWWWWWWWWWWWWWWWWWWWWWWWWWWW
W--WLevel1-----------------------------------------------------------------------------------------------------------------------W
W--------------------------------------------------------------------------------------------------------------WWWWWWWWWWWWWWWWW-W
W-------------------------------------------------------------------------------------------------------------W----------------W-W
W-------------------------------------------------------------------------------------------------------------WWWWWWWWWWWWWWWW-W-W
W-----------------------------------------------------------------------------------------WWWWWWWWWWWW-----------------------W-W-W
W-----------------------------------------------------------------------------------------W----------W-WWWWWWWWWWWWWWWWWWWW--W-W-W
W-----------------------------------------------------------------------------------------W-WWWWWWWW-W-W------------------W--W-W-W
W-----------------------------------------------------------------WWWWWWWWWWW-------------W-W-W----W-W-W-WWWWWWWWWWWWWWWW-W--W-W-W
W----------------------------------------------------------------------------W------------W-W-W-WW-W-W-W-W--------------W-W--W-W-W
W-----------------------------------------------------------------------------W-----------W-W-W-WW-W-W-W-W--------------W-W--W-W-W
W------------------------------------------------------------------------------W----------W-W-W-WW-W-W-W-W--------------W-W--W-W-W
W-------------------------------------------------------------------------------W---------W-W-W-WW-W-W-W-W--------------W-W--W-W-W
W--------------------------------------------------------------------------------W--------W-W-W-WW-WWW-W-W--------------W-W--W-W-W
W---------------------------------------------------------------------------------W-------W-W-W--------W-W--------------W-W--W-W-W
W----------------------------------------------------------------------------------W------W-W-WWWWW-WWWW-WWWWWWWWWWWWWWWW-W--W-W-W
W-----------------------------------------------------------------------------------W-----W-W-----W--W--------------------W--W-W-W
W------------------------------------------------------------------------------------W----W-WWWWWWW--W-W-WWWWWWWWWWWWWWWWWW--W-W-W
W-------------------------------------------------------------------------------------W---W----------W-W---------------------W-W-W
W--------------------------------------------------------------------------------------W--WWWWWWWWWWWW-WWWWWWWWWWWWWWWWWWWWWWW-W-W
W---------------------------------------------------------------------------------------W--------------------------------------W-W
W----------------------------------------------------------------------------------------WWWWWWWWWWWWWWWWWWWWWWWWWWWWWWWWWWWWWWW-W
W--------------------------------------------------------------------------------------------------------------------------------W
W--------------------------------------------------------------------------------------------------------------------------------W
WWWWWWWWWWWWWWWWWWWWWWWWWWWWWWWWWWWWWWWWWWWWWWWWWWWWWWWWWWWWWWWWWWWWWWWWWWWWWWWWWWWWWWWWWWWWWWWWWWWWWWWWWWWWWWWWWWWWWWWWWWWWWWWWWW
