W-WWW--------------------------WWWW-----WWWWWWWWWWWWWWWWWWWWWWWWWWWWWWWWWWWWWWWWWWWWWWWWWWWWWWWWWWWWWWWWWWWWWWWWWWWWWWWWWWWWWWWWWW
W-W-W------------------WW-WW-W--WW-W------------------W----------W----------------------------------------------------------------
WWW--WWW--------------W------W------W------------------W--------W-----W---------------------------------------------------WWWWWWWW
---------------------W------W--------W-------------W----W------W-------W-------------------------------------------------W--------
--------------------W-W----W-------W--W-----------W-W--W------W---------W------------------------------------------------WWWWWWWWW
-WWWW-W------------W-WWW--W---------W--W---------W---W--------W----------W---------------------------WWWWWW-WW-WW-----------------
------W--------------WW--W-------W---W--W-------W-----W-------W--------------------------------------W----------W-WWWWWWWWWWWWWWWW
-WW-----W----------------W------W-----W--W-----W-------W-------W-------------------------------------W-WW-WWWW----W---------------
---W--W-----------W------WW----W-------W--W---W---------W--------------------------------------------W-W-W----W-W-W-WWWWWWWWWWWWWW
---W--W-W---------W-W-W----------------------------------W-------------------------------------------W---W-W--W-W---W-------------
-W----W-W--------W-------WW-WW-----------W--W----W--------W------------------------------------------W-W-W--W-W-W-W-W-------------
-W-W--W-W---------------------------------W----------------W-------------WWW---------------------------W-W-WW-W---W-W-------------
-W-W--W-W----------W--WW----------------------WW------------W-----------W---W------------------------------WW-W-W-W-W-------------
---W----W-----------W--W-WWW-W-----------W-------------------W-----------W---W-----------------------W-W-W-WW--WW-W-W-------------
-W-W--W-W-W--------------------------------------W------------W---W-------W---W----------------------W-W-W--------W-W-------------
-W----W---W-----------WW-WWW-----------W---W----W------------------W-------W---W---------------------W-W-WWW-W-WWWW-WWWWWWWWWWWWWW
-W-W--W-W--W-----------WW-W-----------W-----W--W---W----------------W-----W-----W--------------------W-W-----W--W-----------------
---W--W-W--W------------WW----------WW-------WW-----W------------W---W---W----WWWW-------------------W-WWW-WWW--W-W-WWWWWWWWWWWWWW
-WWW------W------------------------------------------W------------W---WWW----W-----------------------W----------W-W---------------
------W-W-WW-------------------------------------------------------W--------W------------------------WWW-WWWWWWWW-WWWWWWWWWWWWWWWW
-WWWWWW-W-WW-------------------------------------------W------------W------W------------------------------------------------------
--------W-WWWWWWWWWWWWW------WWWWWW----------WWWWWWWWWWWW------------W--WWW-------------------------WWWWWWWWWWWWWWWWWWWWWWWWWWWWWW
----------WW----------------------------------------------------------WW----------------------------------------------------------
----------------------------------------------------------------------------------------------------------------------------------
-----------------------------WWWWWWWWWWWWWWWWWWWWWWW-----------------WW-------WWWWWWWWW---W---------------------------------------
