WWWWWWWWWWWWWWWWWWWWWWWWWWWWWWWWWWWWWWWWWWWWWWWWWWWWWWWWWWWWWWWWWWWWWWWWWWWWWWWWWWWWWWWWWWWWWWWWWWWWWWWWWWWWWWWWWWWWWWWWWWWWWWWWWW
W--WLevel4-----------------------------------------------------------------------------------------------------------------------W
W--------------------------------------------------------------------------------------------------------------------------------W
W---------------------+++--------------------------------------------------------------------------------------------------------W
W--------------------+---+-------------------------------------------------------------------------------------------------------W
W-------------------+-----+------------------------------------------------------------------------------------------------------W
W--------------------+-----+-----------------------------------------------------------------------------------------------------W
W---------------------+-----+----------------------------------------------------------------------------------------------------W
W----------------------+++++++-+-+--+--++---+------+-----------------------------------------------------------------------------W
W-----------------------------+--------------------------------------------------------------------------------------------------W
W------------------------------+-------------------------------------------------------------------------------------------------W
W-------------------------------+------------------------------------------------------------------------------------------------W
W--------------------------------+-----------------------------------------------------------------------------------------------W
W--------------------------------------------------------------------------------------------------------------------------------W
W--------------------------------------------------------------------------------------------------------------------------------W
W--------------------------------------------------------------------------------------------------------------------------------W
W--------------------------------------------------------------------------------------------------------------------------------W
W--------------------------------------------------------------------------------------------------------------------------------W
W--------------------------------------------------------------------------------------------------------------------------------W
W--------------------------------------------------------------------------------------------------------------------------------W
W--------------------------------------------------------------------------------------------------------------------------------W
W--------------------------------------------------------------------------------------------------------------------------------W
W--------------------------------------------------------------------------------------------------------------------------------W
W--------------------------------------------------------------------------------------------------------------------------------W
WWWWWWWWWWWWWWWWWWWWWWWWWWWWWWWWWWWWWWWWWWWWWWWWWWWWWWWWWWWWWWWWWWWWWWWWWWWWWWWWWWWWWWWWWWWWWWWWWWWWWWWWWWWWWWWWWWWWWWWWWWWWWWWWWW
