WWWWWWWWWWWWWWWWWWWWWWWWWWWWWWWWWWWWWWWWWWWWWWWWWWWWWWWWWWWWWWWWWWWWWWWWWWWWWWWWWWWWWWWWWWWWWWWWWWWWWWWWWWWWWWWWWWWWWWWWWWWWWWWWWW
W--WLevel1-----------------------------------------------------------------------------------------------------------------------W
W--------------------------------------------------------------------------------------------------------------------------------W
W--------------------------------------------------------------------------------------------------------------------------------W
W--------------------------------------------------------------------------------------------------------------------------------W
W----WW--------W----------W------------------------------------------------------------------------------------------------------W
W---W--W------W-W--------W-W----------W----------WW------------------------------------------------------------------------------W
W--W----W----W---W------W---W--------W-W--------W--W-----------------------------------------------------------------------------W
W-W------W--W-----W----W-----W------W---W------W----W----------------------------------------------------------------------------W
W--W------WW-------W--W-------W----W-----W----W------W---------------------------------------------------------------------------W
W---W---------------WW---------W--W-------W--W---WW---WWW------------WWW---------------------------------------------------------W
W----W------WW------------------WW---------WW---W--W----------------W-W----------------------------------------------------------W
W-----W----W--W--------WWW----------W----------W----W--------W-------W-----------------------------------------------------------W
W------W--W----W------W---W--------W-W--------W------W--------W---W-W------------------------------------------------------------W
W-------WW------W----W-----W------W---W------W--------W--------W---W-------------------------------------------------------------W
W----------------W--W-------W----W-----W----W----------W--------WWW--------------------------------------------------------------W
W-----------------WW---------W--W-------W--W------------W------------------------------------------------------------------------W
W-----------------------------WW---------WW--------------W-----------------------------------------------------------------------W
W--------------------------------------------------------------------------------------------------------------------------------W
W--------------------------------------------------------------------------------------------------------------------------------W
W--------------------------------------------------------------------------------------------------------------------------------W
W--------------------------------------------------------------------------------------------------------------------------------W
W--------------------------------------------------------------------------------------------------------------------------------W
W--------------------------------------------------------------------------------------------------------------------------------W
WWWWWWWWWWWWWWWWWWWWWWWWWWWWWWWWWWWWWWWWWWWWWWWWWWWWWWWWWWWWWWWWWWWWWWWWWWWWWWWWWWWWWWWWWWWWWWWWWWWWWWWWWWWWWWWWWWWWWWWWWWWWWWWWWW
