WWWWWWWWWWWWWWWWWWWWWWWWWWWWWWWWWWWWWWWWWWWWWWWWWWWWWWWWWWWWWWWWWWWWWWWWWWWWWWWWWWWWWWWWWWWWWWWWWWWWWWWWWWWWWWWWWWWWWWWWWWWWWWWWWW
W-+WWWWWWWW----------------------------------------WW-------WWWWWWWWW---W--------------------------------------------------------W
W-W-------WWWWWWWWWWWWWWWWWW-WWWWW---WWWWWWWWWWWWWWWWWWW-W--W-------W---W-WWWWWWWWWWWWWWWWWWWWWWWWWWWWWWW--WW--WWWWWWWWWWWWWWWWW-W
W-W--WWWW----------------------------------------W----W--W--W-----WWW---W---------------WWWWWWWWWWWWWWWWW--WW-W----------------W-W
W-W--W--W-WWWWWWWWWWWWWWWWWW-WWWW-WWWWWWWW------W------W-W--WWW---W-----WWWWWWWWWWWWWWW-W--------------WW--WW-WWWWWWWWWWWWWWWW-W-W
W-W--W--W-WWWWWW----------------------WWWW-WWWWW--WWWWW--W-----W--W-------------------W-W-WWWWWWWWWWWW-----------------------W-W-W
W-W--W--W------W-WWW-WWWWWWWWWWWWWWWW-W-------W----------WWWW--W--W---WWWWWWWWWWWWWW--W-W-W----------W-WWWWWWWWWWWWWWWWWWWW--W-W-W
W-W--W--W-WWW--W-W---W------------W-W-W-WW-WWWWWWWWWWWWWW---W--W--W---W------------W--W-W-W-WWWWWWWW-W-W------------------W--W-W-W
W-W--W--W-W-W--W-W---W------------W-W-W-W---WW----------W---W--W--W---W--WWWWWWWW--W--W-W-W-W-W----W-W-W-WWWWWWWWWWWWWWWW-W--W-W-W
W-W--W--W-W-WW-W-W---W------------W-W-W-W--WWW------WW--W---W--W--W---W-W-------W--W--W-W-W-W-W-WW-W-W-W-W--------------W-W--W-W-W
W-W--W--W-W--W-W-W---W------------W-W-W-W-WW-W-------W--W---W--W--W---W-W-WWWWWWW--W--W-W-W-W-W-WW-W-W-W-W--------------W-W--W-W-W
W-W--W--W-W--W-W-W---W------------W-W-W-WW-W-W-------W-WW---W--W--W---W-W-W----WW--W--W-W-W-W-W-WW-W-W-W-W--------------W-W--W-W-W
W-W--W--W-W--W-W-W---W------------W-W-W-W--W-W--------------W--W--W---W-W-W----WW--W--W-W-W-W-W-WW-W-W-W-W--------------W-W--W-W-W
W-W--W--W-W--W-W-W---W------------W-W-W----W-W--------------W--W--W---W-W-W----WW--W--W-W-W-W-W-WW-WWW-W-W--------------W-W--W-W-W
W-W--W--W-W--W-W-W---W------------W-W-W-W--W-W---WWWWWWWWWWWW--W--W---W-W-WWW------W--W-W-W-W-W--------W-W--------------W-W--W-W-W
W-W--W--W-W--W-W-W---W------------W-W-W-W--W----W----------WW--W--WWWWW-W------WW--W--W-W-W-W-WWWWW-WWWW-WWWWWWWWWWWWW-WW-W--W-W-W
W-W--W--W-W--W-W-W---W------------W-W-W-W--W---W-----------WW--W--------WWWWWWWWW--W--W-W-W-W-----W--W--------------------W--W-W-W
W-W--W--W-W--W-W-W----------------W-W-W-W--W---W-----------WW-------------------W--W--W-W-W-WWWWWWW--W-W-WWWWWWWWWWWWWWWWWW--W-W-W
W-W--W--W-W--W-W-WWWWWWWWWWWWWWWWWW-W-W-W--W---W-----------WW--WWWWWWWWWWWWWWWWWW--W--W-W-W----------W-W---------------------W-W-W
W-W--W--W----W-W--------------------W-W-W--W---W------WWWWWWW-------------------W--W--W-W-W-WWWWWWWWWW-WWWWWWWWWWWWWWWWWWWWWWW-W-W
W-W--W--WWWWWW-WWWWWWWWWWWWWWWWWWWWWW-W-W--W---W------------WWWWWWWW--W-W--WWWWWW--WWWW-W--------------------------------------W-W
W-W-----------------------------------W-W---WWW---------------------------------W-------WWWWWWWWWWWWWWWWWWWWWWWWWWWWWW-WWWWWWWWW-W
W-WWWWWWW-WWWWWWWWWWWWWWWWWWWWWWWWWWWWW-W---------------------------------------WWWWWWW------------------------------------------W
W---------WWWWWWWWWWWWWWWWWWWWWWWWWWWWWWW----------------------------------------------------------------------------------------W
WWWWWWWWWWWWWWWWWWWWWWWWWWWWWWWWWWWWWWWWWWWWWWWWWWWWWWWWWWWWWWWWWWWWWWWWWWWWWWWWWWWWWWWWWWWWWWWWWWWWWWWWWWWWWWWWWWWWWWWWWWWWWWWWWW
