WWWWWWWWWWWWWWWWWWWWWWWWWWWWWWWWWWWWWWWWWWWWWWWWWWWWWWWWWWWWWWWWWWWWWWWWWWWWWWWWWWWWWWWWWWWWWWWWWWWWWWWWWWWWWWWWWWWWWWWWWWWWWWWWWW
W------+------------W--------W-----W-----------------------W------WW---------------W--------WWWK-oo-------o---ooIII-bb---WK---xx-W
W-------------------W--------x-----W---WWWWWWWWWWW---W------------WW---œœ------bbbbW----------WWWWWWWWWWWWW-oIII---WWW---WWWWW--xW
WWWWWWWWW--W--------WoWWWWWWWW-----W------------KW---W-----W------WWWWWWWWWWWWWW---W-----oo---------------WIII-----W-W-------W---W
Wxx--x--W--WWWWWWW----W---W--------x--WWWWWWWWWWWW--WWWWWWWW-----------B-------W------------oo-----W------WWWWWWbbWW-W-------Wxx-W
W-x----xW--W-----o----W---WWWWWWWWWWWWW------------------W----WWWWWWWW--B-BBB-WWWWWWWWWWWWWo-WWW---W-x--xxW----------W---WWW-Wx--W
WIIWWWx-W--W-----o----W---------------xx----x---xxx------W----W--------B------W--------------o-W---W-xx--xWWWWW------W---W-W----xW
WII-WWœKW--W--K-WWWWWWW---WWWWWWWWWW--x----x-------x-----WWWWWW---------BBBB------WW--I--o-o-o-W---W-----x----W---W--WWWWW-W-W-x-W
WII-WWWWWxxW----W---------W--------W--xx-WWWWWWWWWW------W-------WWWWWWWWWWWWWW----W-xx--WWWWWWWWWWW---xx-----W---W--W-----WWW---W
Wxx-W---WWWW----W------------------W-----W---------------W---W---WooIIIIII---------W-Ix--W--W--W--------------W---WWWW-----W---x-W
-xx-W---W------WW---------W--------W----KWWWWWWWWWWWWWWW-W---W---Woooo-œW----------W-Ixx-W--W--W---WWWWWWW-x--W---WWœW-W---W---x-W
W---W---W------W---WWxxxWWW--------W--WWWW---------W-----W---W---WWWWWWWW---WWWWWWWW-IIx-W--W--x--WW-------x--W---WW-W-W---W---x-W
W---W---W---WWWW---W------------------W------------W-B-B-WWWDW---WW---------W------------W--W-xœx-W-----------W---WW---W-WWW-----W
W---W---W----------W---------WWWWW----W------WWWWWWWB-B-B----W---WW---------W-----WWWWWWWW-----x--WbbWWWWWWWWWW---WW---W-W-W--W--W
W---W---WWWWWWWWWWWW---------W---W----W------W-----Wb-b-B----W-------WWWWW--W------------WWWWW----W-------W-------WW-WWW-W-WWWW--W
W---b------------------WWWWWWW---W----W--WWWWW-xxx-W-b-------W-------W-------WWWWWWWWW------------W-------o--------W-W---W-------W
W---W------------------W----o---oW----W----------x-W--WWWWWWWWbbWWWWWW----------------------------Wooooo--WWW------WWW--WW----oo-W
W---W------------------W--ooo----W----W------------W--W-----oo-oooo--W---WWW------WWWWWWWWWW-WWWWWW--o-oooooW---WWWW-----W-----o-W
W---WWWWWWWWWWWWWWWWWWWW-------ooW----W---W---WWWWWWooo--oo--o---oo--W---W---WWWWWW------------------ooo----W---W--------WWWW-oo-W
W----------bo---oo--oo--oo---o-o-WWWWWWœ--W---W--œœW--WWWW-o--WWWWWWWW---W-------------------W--------------W---W--------W--W----W
W----------W-oooo--oooooo---------x-WWWWWWW---W----WKW--ooo-----ooW------W-------W---WWWWWWW-WWWWWWWWWWWWWWWW------------W--W---oW
W----------WWWWWWWWWWWWWWWWWW-x--x----xx---x--W----WWW-----oooooo-WWWWWWWWWWWWWWWW---------W----------------WWWWWWWWWWWWWW--W-oooW
WWWWWWWWWWWW----------------W--xxxx----xx--x-------WWWDWWWWWWWWWWWWW-----W-----------------D-------------------------------------W
WK-oo--xxxxxIIIIIII-----------x------WWWWWWWWWWW--WWWW---xx--xxx-+WWWWWWWW-----------------W--------------------------------W----W
WWWWWWWWWWWWWWWWWWWWWWWWWWWWWWWWWWWWWWWWWWWWWWWWWWWWWWWWWWWWWWWWWWWWWWWWWWWWWWWWWWWWWWWWWWWWWWWWWWWWWWWWWWWWWWWWWWWWWWWWWWWWWWWWWW
