WWWWWWWWWWWWWWWWWWWWWWWWWWWWWWWWWWWWWWWWWWWWWWWWWWWWWWWWWWWWWWWWWWWWWWWWWWWWWWWWWWWWWWWWWWWWWWWWWWWWWWWWWWWWWWWWWWWWWWWWWWWWWWWWWW
<<<<<<<HEADW---------WIIIIIIIW-------b---------------------------W----------------------------------------------------------b-----
----------WW---------WIIIIIIIW-------W---------------------------W------------------------IIIIIIIIIIIIIIIIIIIIIIIIIIIII-----W-----
----------WWWWWWWWW--WIIIIIIIW-------W---------------------------W------------------------IIIIIIIIIIIIIIIIIIIIIIIIIIIII-----W-----
----------WW---------WIWWWWWIW-------W---------------------------W------------------------IIIIIIIIIIIIIIIIIIIIIIIIIIIII-----W-----
-++++++++-WW---------WIIIIIWIW-W-----W---------------------------W------------------------IIIIII----------------------------W-----
----------WW-WWWWWWWWWIIIIIWIW-W-----W---------------------------W------------------------IIIIII----------------------------W-----
----------WW------WIKWIIIIIWIW-W-----WWWWWWWWWWWWWWWWWWW---------W------------------------IIIIII----------------------------W-----
----------WW------WIIIIIIIIWI--W-----W-----------------W---------W------------------------IIIIII----------------------------W-----
--------œKWW------WIIIIIIIIWIW-W-----W-----------------W----WWWWWW------------------------IIIIII----------------------------WWWWWW
WWWWWWWWWWWW------WWWWWWWWWWIW-W-----W-----------------W---------W------------------------IIIIII----------------------------------
----------WW------W-IIIIIIIIIW-W-----W-----------------W---------W------------------------IIIIII----------------------------------
----------WW------D-IIIIIIIIIW-W-----W---------WWWWWWWWW---------W------------------------IIIIII----------------------------------
----------WW------W-IIIIIIIIIW-W-----W-----------------WWWWWWW---W------------------------IIIIII----------------------------------
----------WW------WWWWWWWWWWWW-W-----W-----------------W---------W------------------------IIIIII----------------------------------
----------WWWWWWW-W------------W-----WWWWWWWWW---------W---------W------------------------IIIIII----------------------------------
----------WW------W------------W-------------W--WWWWWWWW---W-----W------------------------IIIIII----------------------------------
----------WW-WWWWWW------------W-------------W--W------W---W-----W------------------------IIIIII----------------------------------
----------WW------WWWWWWWWWWWWWWWWWWWWWWWW---W--WbbbbbbW---WWWWWWW------------------------IIIIII----------------------------------
----------WWB-B-B-WWœ--W----WB-B--B--B-W-W---W--WbbbbbbW---------W------------------------IIIIII---------------------WWWWWWWWWWWWW
WWWWWWWWWWWWBBBBBBWW---W----W-B-B-W-B-BW-W---W--WbbbbbbW---------W------IIIIIIIIIIIIIIIIIIIIIIII---------------------WbbBbB+++++++
++++++++++WW-B-B-BWW---W----BB--B-WBBB-W-D---W---------W----WWWWWW------IIIIIIIIIIIIIIIIIIIIIIII---------------------DbBbbb+++++++
++++++++++WW------WW----BBBBW-B---W------W---W---------W----------------IIIIIIIIIIIIIIIIIIIIIIII---------------------WbbBbb+++++++
++++++++++WWK-----WWœ--W----W--B--W----W-W---W-----------------------------------------------------------------------WBbbbB+++++++
++++++++++W=======W--CLevel1------------------------------------------------------------------------------------------------------
