WWWWWWWWWWWWWWWWWWWWWWWWWWWWWWWWWWWWWWWWWWWWWWWWWWWWWWWWWWWWWWWWWWWWWWWWWWWWWWWWWWWWWWWWWWWWWWWWWWWWWWWWWWWWWWWWWWWWWWWWWWWWWWWWWW
W-+WLevel1-----------------------------------------------------------------------------------------------------------------------W
W-WW-----------------------------------------------------------------------------------------------------------------------------W
W-K---WWWW--WW--DD---------------------------------------------------------------------------------------------------------------W
W----W--------W------------------------------------------------------------------------------------------------------------------W
W----W--+---+--------------------------------------------------------------------------------------------------------------------W
W--------------W-----------------------WW----++------W---------------------------------------------------------------------------W
W----W--W-W-W--W--W---WW-WW-W--WWWWWWWWWWW---------------------------------------------------------------------------------------W
W-----------------------------------------W--------------------------------------------------------------------------------------W
W----------------------WWW-----------------W-----WWWWWWWWWW--WWWW----------------------------------------------------------------W
W---------------------W--W----------W-----+-W-------------------W----------------------------------------------------------------W
W--------------W-----W---W-----------------+-WWWWWWWWWWWWWW-----W----------------------------------------------------------------W
W--------------W----W----W--------W---------+-------------W----------------------------------------------------------------------W
W--------------W-----------------W------WWW--+------------W----------------------------------------------------------------------W
W--------------W------------------------------++---++++++--------+---------------------------------------------------------------W
W--------------W-----------------------------WWW---WWWW--------W-----------------------------------------------------------------W
W-----------------------------W-----WW------W---------W-------W------------------------------------------------------------------W
W------------------W-WWWWWWW----------W----W-----------W-----W-------------------------------------------------------------------W
W--------------------------------------WWWW-------------W---W--------------------------------------------------------------------W
W------------------------------------------------WWWW----WWW---------------------------------------------------------------------W
W-------------------------------------------W-------W----------W-----------------------------------------------------------------W
W-------------------------------------------W------W--------W----WW-WW-W-WW-W-WWWWWWWW-WW----------------------------------------W
W--------------------------------------------W----W------------------------------------------------------------------------------W
W---------------------------------------------W--W-------------------------------------------------------------------------------W
WWWWWWWWWWWWWWWWWWWWWWWWWWWWWWWWWWWWWWWWWWWWWWWWWWWWWWWWWWWWWWWWWWWWWWWWWWWWWWWWWWWWWWWWWWWWWWWWWWWWWWWWWWWWWWWWWWWWWWWWWWWWWWWWWW
