WWWWWWWWWWWWWWWWWWWWWWWWWWWWWWWWWWWWWWWWWWWWWWWWWWWWWWWWWWWWWWWWWWWWWWWWWWWWWWWWWWWWWWWWWWWWWWWWWWWWWWWWWWWWWWWWWWWWWWWWWWWWWWWWWW
W-+level_3++---------------------------------------------------------------------------------------------------------------------W
W++++++++++++++++++++++++++++----------------------------------------------------------------------------------------------------W
W+++++---W-------WWW---+++++++---------------------------------------------------------------------------------------------------W
W+++++WWW-W-----W---W---+++++++-------------------------------+++++++++++--------------------------------------------------------W
WWWWWWWWWWWWWWWWWWW-++++++++++-------------------------------+-----------+-------------------------------------------------------W
+----++++---W-WWWW----W--W+++W------------++++++++++--------+-------------+------------------------------------------------------W
+----+-------W-W--W--+-W------W----------+----------+------+---------------+-----------------------------------------------------W
+----+-------WW+---W+---W--W-WW---------+------------+----+-----------------+----------------------------------------------------W
++---+-++--++-WW+--+W----W-WW--W-------+--------------+--+------------------+----------------------------------------------------W
+-+-++-+-++--+-WW----W----WW----------+----------------++------------------+-----------------------------------------------------W
+----+--+----+--WW----W---WW----------+----------------+------------------+------------------------------------------------------W
+----++--+--+----WW----W-W-------------+---------------------------------+-------------------------------------------------------W
+----+-++-+++-----WWWWW-W---------------+-------------------------------+--------------------------------------------------------W
+----+----+---------W--W-----------------+-----------------------------+---------------------------------------------------------W
+----+---------------WW-------------------+-------------------------+++----------------------------------------------------------W
++++++++++++++++++++++---------------------+-----------------------+-------------------------------------------------------------W
W-------------------------------------------++++++----------------+--------------------------------------------------------------W
W-------------------------------------------------++-------------+---------------------------------------------------------------W
W---------------------------------------------------+++---------+----------------------------------------------------------------W
W------------------------------------------------------+++++++++-----------------------------------------------------------------W
W--------------------------------------------------------------------------------------------------------------------------------W
W--------------------------------------------------------------------------------------------------------------------------------W
W--------------------------------------------------------------------------------------------------------------------------------W
WWWWWWWWWWWWWWWWWWWWWWWWWWWWWWWWWWWWWWWWWWWWWWWWWWWWWWWWWWWWWWWWWWWWWWWWWWWWWWWWWWWWWWWWWWWWWWWWWWWWWWWWWWWWWWWWWWWWWWWWWWWWWWWWWW
