WWWWWWWWWWWWWWWWWWWWWWWWWWWWWWWWWWWWWWWWWWWWWWWWWWWWWWWWWWWWWWWWWWWWWWWWWWWWWWWWWWWWWWWWWWWWWWWWWWWWWWWWWWWWWWWWWWWWWWWWWWWWWWWWWW
W-WK--------------------------W--------------------------------------------------------------------------------------------------W
W-W---------------------------W--------------------------------------------------------------------------------------------------W
W-W---------------------------W--------------------------------------------------------------------------------------------------W
W-W---------------------------D--------------------------------------------------------------------------------------------------W
W-W---------------------------W--------------------------------------------------------------------------------------------------W
W-W---------------------------W--------------------------------------------------------------------------------------------------W
W-W------‹‹‹------------------W--------------------------------------------------------------------------------------------------W
W-WWWWWWW‹‹‹WWWWWWWWWWWWWWWWWWW--------------------------------------------------------------------------------------------------W
W-W-----W---W-----W--------------------------------------------------------------------------------------------------------------W
W-W-----W---W-----W--------------------------------------------------------------------------------------------------------------W
W-W-----W---W-----W--------------------------------------------------------------------------------------------------------------W
W-W-----W---W-----W--------------------------------------------------------------------------------------------------------------W
W-WK--------D----úW--------------------------------------------------------------------------------------------------------------W
W-W-----W---W-----W--------------------------------------------------------------------------------------------------------------W
W-W-----W---W-----W--------------------------------------------------------------------------------------------------------------W
W-W-----W---W-----W--------------------------------------------------------------------------------------------------------------W
W-W-----W---W-----W--------------------------------------------------------------------------------------------------------------W
W-W-----W---W-----W--------------------------------------------------------------------------------------------------------------W
W-WWWWWWW---WWWWWWW--------------------------------------------------------------------------------------------------------------W
W-W------BBB------W--------------------------------------------------------------------------------------------------------------W
W-W-----B---B-----W--------------------------------------------------------------------------------------------------------------W
W-W----B-BBB-B----W--------------------------------------------------------------------------------------------------------------W
W-----------------W-------------------------------------------------------------------------------------------------------------+W
WWWWWWWWWWWWWWWWWWWWWWWWWWWWWWWWWWWWWWWWWWWWWWWWWWWWWWWWWWWWWWWWWWWWWWWWWWWWWWWWWWWWWWWWWWWWWWWWWWWWWWWWWWWWWWWWWWWWWWWWWWWWWWWWWW
