WWWWWWWWWWWWWWWWWWWWWWWWWWWWWWWWWWWWWWWWWWWWWWWWWWWWWWWWWWWWWWWWWWWWWWWWWWWWWWWWWWWWWWWWWWWWWWWWWWWWWWWWWWWWWWWWWWWWWWWWWWWWWWWWWW
W--WLevel6-----------------------------------------------------------------------------------------------------------------------W
W--------------------------------------------------------------------------------------------------------------------------------W
W--------------------------------------------------------------------------------------------------------------------------------W
W-----------------------------------------------W----W---------------------------------------------------------------------------W
W------------------------WWWWWW--W--------------W----W---------------------------------------------------------------------------W
W------------------------W-------W--------------W----W---------------------------------------------------------------------------W
W------------------------W-------W--------------W----W---------------------------------------------------------------------------W
W--------------W---------WWWWWW--W-----------------------------------------------------------------------------------------------W
W--------------W---------W-------W---------WWWW--------WWWW-+--------------------------------------------------------------------W
W--------------W---------W-------W------------WWWWWWWWWW-------------------------------------------------------------------------W
W--------------WWWWWW----WWWWWWW-W-----------------------------------------------------------------------------------------------W
W--------------------------------WWWWWWWW----------------------------------------------------------------------------------------W
W--------------------------------------------------------------------------------------------------------------------------------W
W--------------------------------------------------------------------------------------------------------------------------------W
W--------------------------------------------------------------------------------------------------------------------------------W
W--------------------------------------------------------------------------------------------------------------------------------W
W--------------------------------------------------------------------------------------------------------------------------------W
W--------------------------------------------------------------------------------------------------------------------------------W
W--------------------------------------------------------------------------------------------------------------------------------W
W--------------------------------------------------------------------------------------------------------------------------------W
W--------------------------------------------------------------------------------------------------------------------------------W
W--------------------------------------------------------------------------------------------------------------------------------W
W--------------------------------------------------------------------------------------------------------------------------------W
WWWWWWWWWWWWWWWWWWWWWWWWWWWWWWWWWWWWWWWWWWWWWWWWWWWWWWWWWWWWWWWWWWWWWWWWWWWWWWWWWWWWWWWWWWWWWWWWWWWWWWWWWWWWWWWWWWWWWWWWWWWWWWWWWW
