WWWWWWWWWWWWWWWWWWWWWWWWWWWWWWWWWWWWWWWWWWWWWWWWWWWWWWWWWWWWWWWWWWWWWWWWWWWWWWWWWWWWWWWWWWWWWWWWWWWWWWWWWWWWWWWWWWWWWWWWWWWWWWWWWW
W--CLevel1-----------------------------------------------------------------------------------------------------------------------W
W--------------------------------------------------------------------------------------------------------------------------------W
W--------------------------------------------------------------------------------------------------------------------------------W
W--------------------------------------------------------------------------------------------------------------------------------W
W---------+----------------------------------------------------------------------------------------------------------------------W
W--------------------------------------------------------------------------------------------------------------------------------W
W--------------------------------------------------------------------------------------------------------------------------------W
W--------------------------------------------------------------------------------------------------------------------------------W
W--------------------------------------------------------------------------------------------------------------------------------W
W--------------------------------------------------------------------------------------------------------------------------------W
W--------------------------------------------------------------------------------------------------------------------------------W
W--------------------------------------------------------------------------------------------------------------------------------W
W--------------------------------------------------------------------------------------------------------------------------------W
W--------------------------------------------------------------------------------------------------------------------------------W
W--------------------------------------------------------------------------------------------------------------------------------W
W--------------------------------------------------------------------------------------------------------------------------------W
W--------------------------------------------------------------------------------------------------------------------------------W
W--------------------------------------------------------------------------------------------------------------------------------W
W--------------------------------------------------------------------------------------------------------------------------------W
W--------------------------------------------------------------------------------------------------------------------------------W
W--------------------------------------------------------------------------------------------------------------------------------W
W--------------------------------------------------------------------------------------------------------------------------------W
W--------------------------------------------------------------------------------------------------------------------------------W
W------W-----W------------------W------------W------------------------W------------------W--------------------------W------------W
W------W-----W------------------W------------W------------------------W------------------W--B-B-B-B-----------------W------------W
W------W-----W------------------W------------W------------------------W------------------W---------WWWWWWWWW--------W------------W
W------W-----W-----------------œWWWWWWWWWWWWWW------------------------W------------------W--B-B-B-BWbWWbbbbW--------W------------W
W------W--W--W--W---------------b-------------------------------------WWWWWWWWWWWWWWWWWWWW---------WbWWbWWWW-WWWWW--W------------W
W------W--W--W--W---------------b--------------------K----------------DIIIIIIIIIIIIIIIIIII--B-B-B-Bbbbbbbbbb-D---W--W------------W
W------W--W--W--W---------------b-------------------------------------WWWWWWWWWWWWWWWWWWWW---------WWWWbWWbW-W-+-W--W------------W
W---------W-----W---------------b-------------------------------------W------------------W--B-B-B-BWbbbbWWbW-W---W--W------------W
W---------W-----W---------------WWWWWWWWWWWWWW------------------------W------------------W---------WWWWWWWWW-WWWWW--W------------W
W---------W-----W---------------W------------W------------------------W------------------W--B-B-B-B-----------------W------------W
W---------W-----W---------------W------------WWWWWWWWWWWWWWWWWWWWWWWWWW------------------WWWWWW-WWWWWWWWWWWWWWWWWWWWW------------W
W---------W-----W---------------W------------W------------------------------------------------W-W--------------------------------W
WWWWWWWWWWWWWWWWWWWWWWWWWWWWWWWWW------------W------------------------------------------------W-W--------------------------------W
W--------------------------------------------W------------------------------------------------W-W--------------------------------W
W--------------------------------------------W-------------------------------------------K----W-W--------------------------------W
W--------------------------------------------W--------------------------------------------------W--------------------------------W
W--------------------------------------------W--------------------------------------------------W--------------------------------W
W--------------------------------------------W--------------------------------------------------W--------------------------------W
W--------------------------------------------W--------------------------------------------------W--------------------------------W
W--------------------------------------------W--------------------------------------------------W--------------------------------W
W--------------------------------------------W--------------------------------------------------W--------------------------------W
W--------------------------------------------W--------------------------------------------------W--------------------------------W
W--------------------------------------------W--------------------------------------------------W--------------------------------W
WWWWWWWWWWWWWWWWWWWWWWWWWWWWWWWWWWWWWWWWWWWWWWWWWWWWWWWWWWWWWWWWWWWWWWWWWWWWWWWWWWWWWWWWWWWWWWWWWWWWWWWWWWWWWWWWWWWWWWWWWWWWWWWWWW
