WWWWWWWWWWWWWWWWWWWWWWWWWWWWWWWWWWWWWWWWWWWWWWWWWWWWWWWWWWWWWWWWWWWWWWWWWWWWWWWWWWWWWWWWWWWWWWWWWWWWWWWWWWWWWWWWWWWWWWWWWWWWWWWWWW
W--WLevel1-----------------------------------------------------------------------------------------------------------------------W
W----WWWWWWWWWWW---WWWW------------WWWWWWWWWWWWWWWWWWWWW-------------------------------------------------------------------------W
W----W-------------W---W-----------W--------------------W------------------------------------------------------------------------W
W-------------+----WWWWW-----------W------WWWWWW---------W-----------------------------------------------------------------------W
W----W------++---------------------W------W----W----------W----------------------------------------------------------------------W
W----W--------+--WW---------WWWW-WWWWW----W----WWWWWW------W---------------------------------------------------------------------W
W----W------+--+---W--------W------W--W---W---------W-------W--------------------------------------------------------------------W
W----W----------+---W-------W------W---W--WWWWWW---WW--------W-------------------------------------------------------------------W
W----W----+++----+---W------WWWW---W----W------W-W--W---------W------------------------------------------------------------------W
W----W-------+----+---W--------W---W-----W-------W--WW--W--WW--W----------------WWWWWWWWWWWWWWWWWWWWW----------------------------W
W----W--------+--+-----W--------WWWW------W------WW---------W---W---------------W-------------------W----------------------------W
W----WWWWWWWWW-++-------W------------------WWWWWWWW---------W----W--------------W-------------------W----------------------------W
W------------W-++---WWW--W----------------------------------------W-------------W-------------------W----------------------------W
W------------W-+-+--W-----WWWWWWWWWWWWWWWWWWWWWWWWW---WWW---W-------------------W-------------------W----------------------------W
W------------W--+++-W---------------------------------W-W----WW-WW-WWWWWWWWWWWWWW-------------------W----------------------------W
W------------W------W---------------------------------W-W--------W-W--------------------------------W----------------------------W
W------------W------WWWWWWWW--------------------------W-W--------W-W--------------------------------W----------------------------W
W----WWWWWWWWWWWWWWWW------W--------------------------W-W--------W-W------------WWWWWWWWWWWWWWWWWWWWW----------------------------W
W--------------------------WWWWWWWWWWWWWWWWWWWWWWWWWWWW-W-----------------------W------------------------------------------------W
W-------------------------------------------------------W-----------------------W------------------------------------------------W
W-------------------------------------------------------WWWWWWWWWWWWWWWWWWWWWWWWW------------------------------------------------W
W--------------------------------------------------------------------------------------------------------------------------------W
W--------------------------------------------------------------------------------------------------------------------------------W
WWWWWWWWWWWWWWWWWWWWWWWWWWWWWWWWWWWWWWWWWWWWWWWWWWWWWWWWWWWWWWWWWWWWWWWWWWWWWWWWWWWWWWWWWWWWWWWWWWWWWWWWWWWWWWWWWWWWWWWWWWWWWWWWWW
