WWWWWWWWWWWWWWWWWWWWWWWWWWWWWWWWWWWWWWWWWWWWWWWWWWWWWWWWWWWWWWWWWWWWWWWWWWWWWWWWWWWWWWWWWWWWWWWWWWWWWWWWWWWWWWWWWWWWWWWWWWWWWWWWWW
W-----------W----------W-----------------------W---------------------------------------------------------------------------------W
W-----------D---------KW-----------------------W---------------------------------------------------------------------------------W
WKœ---------W----------W-----------------------W---------------------------------------------------------------------------------W
WWWWWWWWWWWWW----------W-----------------------W---------------------------------------------------------------------------------W
W----------W-----------W-----------------------W---------------------------------------------------------------------------------W
W----------W-----------W-----------------------W---------------------------------------------------------------------------------W
W----------W-----------W-----------------------W---------------------------------------------------------------------------------W
W----------WWWWWWDWWWWWWWWWWWWWWWWWWWWWWWWWWWWWW---------------------------------------------------------------------------------W
W-------------KW------K-----W-------------------B--------------------------------------------------------------------------------W
W--------------W------------W-------------------B--------------------------------------------------------------------------------W
W--------------W------------W-------------------B--------------------------------------------------------------------------------W
W--------------W------------D-------------------B--------------------------------------------------------------------------------W
W--------------W------------W-------------------B--------------------------------------------------------------------------------W
W--------------W------------W-------------------B--------------------------------------------------------------------------------W
W--------------W------------WWWWWWWWWWWWWWWW----B--------------------------------------------------------------------------------W
W--------------D------------W--------------W----B--------------------------------------------------------------------------------W
W--------------W------------W--------------W-------------------------------------------------------------------------------------W
W--------------W------------W--------------W-------------------------------------------------------------------------------------W
W--------------WWWWWWWWWWWWWW--------------D-------------------------------------------------------------------------------------W
W--------------W---------------------------W-------------------------------------------------------------------------------------W
W--------------W---------------------------W-------------------------------------------------------------------------------------W
W--------------W---------------------------W-------------------------------------------------------------------------------------W
W--------------W---------------------------W-------------------------------------------------------------------------------------W
WWWWWWWWWWWWWWWWWWWWWWWWWWWWWWWWWWWWWWWWWWWWWWWWWWWWWWWWWWWWWWWWWWWWWWWWWWWWWWWWWWWWWWWWWWWWWWWWWWWWWWWWWWWWWWWWWWWWWWWWWWWWWWWWWW
