WWWWWWWWWWWWWWWWWWWWWWWWWWWWWWWWWWWWWWWWWWWWWWWWWWWWWWWWWWWWWWWWWWWWWWWWWWWWWWWWWWWWWWWWWWWWWWWWWWWWWWWWWWWWWWWWWWWWWWWWWWWWWWWWWW
W--WWWWWWWWWWWWWWWWWWWWWWWWWWWWWWWWWWWWWWWWWWWWWW-------------------------WWWWWWWWœWWWWWWWWWW---W--W----+--W---W---oo---xx-x--xx-W
W--------------------------------------------------WWWWWWWWWWWWWWWWWWWWWW-WWWWWWWW----------W---D--W-------W---W-oo-oooWWWW----x-W
WWWWWWWWWWWWWWWWWWWWW-WWWWWWWWWWWWWWWWWWWWWWWWWWWWWWIIIIIIIII-----III-II--WWWWWWWWWWWWWW----WW--W--WWWWWDWWW---WWWWWWWWW--WWWWo--W
WWWWWWWWWWWWWWWWWWWWW------WWWWWWWWWW------------W-II---ooo-II-IIII-IIIII-WWWWWWWWWW------------W----------W---WWWW--WW---W--W-xxW
Wx--xxxIIIIxooo-WWWWW------WWWWWWW----------WW---W-I-oo-o-IIoIIIooo-IIoo--WWWWWWW---------------WWWWWWWWWWWW---D-----W----W--W-o-W
WxoWW---I--xxx-x-WWWW------WWWWWWWW---WWWWW--W---WIIo-ooo-Ioooo-oI-o-IIo--WWWWWWW-------------------------W----W-----W----W--WooxW
W-o-W-xxII--x--o--WWW----WWWWWW---W---W---W--W---WIIoIIIoooIIo-oIIooo-oII-WWW-WWW---WWWWWWWW--------------WWWWWWWWWWbW----W--W---W
WooooWx-WIIIxx-o---WW----W-ooo-o--W---W---WWWW---Wo-o-I-oooIIooII-o--o-oooWWW-W---W-----W--W----WWWW---WWWWWWW-W----------W--W-o-W
Wxxxx-W-WW-I--WWWW-WW----W-ooo--o-W---W---W----WWWoo-ooIo---ooooIo-oI-o-o-W-W-W---W-----W------WW--W---WW---WW-Woox-------W--W-o-W
Wo-I--Woo-WII----W-WWW--------I---W-œWW---W----WK--oIIIo-IIo---ooooI-o-o-IW-W-W---W-----W-----WW---W--WW---WW--WoIx--WWWWWW--W-o-W
Wo-I--W-o--WWWWooWxxoW---IIo-I----WWWW----W----WWW-o--o-oIIIooo-o-II-o---IW-W-W---W-----WW----W----W-WW----W---W-I--WW----W------W
Wx--Ix--oo-oKoo--W-ooWW-II-o--WW--W-------W------W-oooI--oo---o--oII-oo-IIW-W-W---WW-----WW---W----WW------WWWWxxx--W-x---W--oWWWW
W-x-Ixx-ooo-o-oooWWIIIW-I-o--W-W--W-------W------WIIooIoo--o-o--o-oI-o--ooW-W-WWW--WW-----WW-----WWW----W--W-------IWxxxWWW--oWWWW
W-xxx---ooooII---WWW-xW--oo--W--WWW--------------WI--I---oo-oooo--ooo----oW-W-W-----W------W----WW-W----W--W-x--xxIIW-x-W-W-o-WWWW
W---ooWo-oIooo--Wooo-xW---Io-W----W--------------WWWWWWWWWWWWWWWW-WWWWWWWWW-W-------W----WWWWW--W--W----W-xxxIIx----W---W-----W-WW
W-xoo-W--I-o-WWW--xx-xWWW-Io-W----W---WWWWWWWWW------------W----------------WWW-----W----W--W---W--W---WWx-III---oWWWWW---WWWWW-WW
W-I-o-W--Ioo-----IIx-x--W-Io-W----W---W------W-------------W------------------WW---WW------WW------W---W-x---oo--WW-------W---W-WW
W-I-o-I--o-xx-xII--xxWWWW-I--W----W----------WWWWWWWWWWWWWWWWWWWWWWWWWWW-------WW-WW------WW-------W---xxI-oWWWWWW--oo-xW-W-----WW
W-I--o-o-ooxx-xo-WWWWW----o--W--------W-----------------------WW----------------WWW-----WWWWWWW----b---W-I-o------------WWW---W-WW
W-I-o-----o---WWW---------oWWWWWWWW---WWWWWWWWWWWWWW----------Wœ-----WWWWWWWWW----------W-----WWWW-W---W-I----WWWWW-x-WWWW--WWW-WW
Wooo-WWWWWWWWWW-----WWWWWWWWWWWWWWWWWWW---------WWWW--WWWWWWWWWWWWWWWW-------------WWWWWW----x-x---WWWWWWIWWWWW-----x-------W-W-WW
W----W------------o-------------WWWWWWWWWWWW-----------x--xxW------xx--xx-----------------xxx---o-----------oo-----WWWWWWWWWW-W-WW
W----b---------ooo---------o------------o-oooo----xx----------xxx---------xxx---x-----------------oo-oooooo--oo---------------WKWW
WWWWWWWWWWWWWWWWWWWWWWWWWWWWWWWWWWWWWWWWWWWWWWWWWWWWWWWWWWWWWWWWWWWWWWWWWWWWWWWWWWWWWWWWWWWWWWWWWWWWWWWWWWWWWWWWWWWWWWWWWWWWWWWWWW
