WWWWWWWWWWWWWWWWWWWWWWWWWWWWWWWWWWWWWWWWWWWWWWWWWWWWWWWWWWWWWWWWWWWWWWWWWWWWWWWWWWWWWWWWWWWWWWWWWWWWWWWWWWWWWWWWWWWWWWWWWWWWWWWWWW
W--WLevel1-----------------W-----W--------W----------------------W---------------------------------------------------------------W
W----WWWWWWWWWWW---WWWW----W--W--W-WWWWWWWWWWWWWWWWWWWWW----------W--------------WWWWWWWWWWW---WWWW------------------------------W
W-W--W-------------W---W---W---W-W-W------W-------------W----------W-------------W---------W----W--W-----------------------------W
W-------------+----WWWWW-----WWW---W------WWWWWW---------W----------W-WWWWWWWWWWWW----WWWWW------W--W----------------------------W
W-+--W------++---------------W-----W------W----W----------W----------W----------------W-----------W--W---------------------------W
W----W--------+--WW------WW-WWWW-WWWWW----W----WWWWWW------W----W-----W---------------W------------W--W--------------------------W
W-WW-W------+--+---W-----W--W------W--W---W---------W-------W---W-++---W--------------W-------------W----------------------------W
W----W----------+---W-------W------W---W--WWWWWW---WW--------W--W---+---WW---+---WWWWWW--------------W---------------------------W
W----W----+++----+---W----+-WWWW---W----W------W-W--W---------W------+--------------------------------W--------------------------W
W----W-------+----+---W----+---W---W-----W-------W--WW--W--WW--W--+---W----+----WWW-WW--W--------------W-------------------------W
W----W--------+--+-----W----+--+WWWW------W------WW---------W---W--+--W+-----------+++-++++++-------W---W------------------------W
W--WWWWWWWWWWW-++-------W-------+----------WWWWWWWW---------W----W--+-W-+-------W-+----------+------W---W------------------------W
W------------W-++---WWW--W-------++WWW+++-+-+--++---+--------W--W-W--+W--+-------+------------+--------W-------------------------W
W------------W-+-+--W-----WWWWWWWWWWWWWWWWWWWWWWWWW---WWW---W---------+---+-----+---+++++++++--+----W-W--------------------------W
W------------W--+++-W------------W--------------------W-W----WWWW------+---+-+++W---+-------+---+---WW---------------------------W
W------------W------WWWWWWWWWWWWW--------------------WWWW--W--+----W----+-----------+-------+--+----W----------------------------W
W------------W------WWWWWWWW--------------------------W-W--W--+--W-W-----++++++++++++++++++++-+----WW----------------------------W
W--W-WWWWWWWWWWWWWWWW------W--------------------------W-W--W--+-------------------WW-+-+++++++WWW-WWW----------------------------W
W---W----W-------W---------WWWWWWWWWWWWWWWWWWWWWWWWWWWW-W--WWWWWWWWWWWWWWWWWWWWWW-----+-----+----W-------------------------------W
W----W----W-----W---W----------W---W---W---W---W--------W-----------------------WW-----+---+----W--------------------------------W
W-----W----W---W----------------W------------------W----WWWW--W--WWWWWWWWWWWWWWWWW------+++----W---------------------------------W
W------W----WWW------------------WWW-----WWWW------W-----------------------------W------------W----------------------------------W
W-------W------------------------------------W-----W-----------------------------WWWWWWWWWWWWW-----------------------------------W
WWWWWWWWWWWWWWWWWWWWWWWWWWWWWWWWWWWWWWWWWWWWWWWWWWWWWWWWWWWWWWWWWWWWWWWWWWWWWWWWWWWWWWWWWWWWWWWWWWWWWWWWWWWWWWWWWWWWWWWWWWWWWWWWWW
