WWWWWWWWWWWWWWWWWWWWWWWWWWWWWWWWWWWWWWWWWWWWWWWWWWWWWWWWWWWWWWWWWWWWWWWWWWWWWWWWWWWWWWWWWWWWWWWWWWWWWWWWWWWWWWWWWWWWWWWWWWWWWWWWWW
W---------WIIIIIIIW-------b---------------------------W----------------------------------------------------------b---------------W
W---------WIIIIIIIW-------W---------------------------W------------------------IIIIIIIIIIIIIIIIIIIIIIIIIIIII-----W---------------W
WWWWWWWW--WIIIIIIIW-------W---------------------------W------------------------IIIIIIIIIIIIIIIIIIIIIIIIIIIII-----W---------------W
W---------WIWWWWWIW-------W---------------------------W------------------------IIIIIIIIIIIIIIIIIIIIIIIIIIIII-----W---------------W
W---------WIIIIIWIW-W-----W---------------------------W------------------------IIIIII----------------------------W---------------W
W-WWWWWWWWWIIIIIWIW-W-----W---------------------------W------------------------IIIIII----------------------------W---------------W
W------WIKWIIIIIWIW-W-----WWWWWWWWWWWWWWWWWWW---------W------------------------IIIIII----------------------------W---------------W
W------WIIIIIIIIWI--W-----W-----------------W---------W------------------------IIIIII----------------------------W-------------œKW
W------WIIIIIIIIWIW-W-----W-----------------W----WWWWWW------------------------IIIIII----------------------------WWWWWWWWWWWWWWWWW
W------WWWWWWWWWWIW-W-----W-----------------W---------W------------------------IIIIII--------------------------------------------W
W------W-IIIIIIIIIW-W-----W-----------------W---------W------------------------IIIIII--------------------------------------------W
W------D-IIIIIIIIIW-W-----W---------WWWWWWWWW---------W------------------------IIIIII--------------------------------------------W
W------W-IIIIIIIIIW-W-----W-----------------WWWWWWW---W------------------------IIIIII--------------------------------------------W
W------WWWWWWWWWWWW-W-----W-----------------W---------W------------------------IIIIII--------------------------------------------W
WWWWWW-W------------W-----WWWWWWWWW---------W---------W------------------------IIIIII--------------------------------------------W
W------W------------W-------------W--WWWWWWWW---W-----W------------------------IIIIII--------------------------------------------W
W-WWWWWW------------W-------------W--W------W---W-----W------------------------IIIIII--------------------------------------------W
W------WWWWWWWWWWWWWWWWWWWWWWWW---W--WbbbbbbW---WWWWWWW------------------------IIIIII--------------------------------------------W
WB-B-B-WWœ--W----WB-B--B--B-W-W---W--WbbbbbbW---------W------------------------IIIIII---------------------WWWWWWWWWWWWWWWWWWWWWWWW
WBBBBBBWW---W----W-B-B-W-B-BW-W---W--WbbbbbbW---------W------IIIIIIIIIIIIIIIIIIIIIIII---------------------WbbBbB+++++++++++++++++W
W-B-B-BWW---W----BB--B-WBBB-W-D---W---------W----WWWWWW------IIIIIIIIIIIIIIIIIIIIIIII---------------------DbBbbb+++++++++++++++++W
W------WW----BBBBW-B---W------W---W---------W----------------IIIIIIIIIIIIIIIIIIIIIIII---------------------WbbBbb+++++++++++++++++W
WK-----WWœ--W----W--B--W----W-W---W-----------------------------------------------------------------------WBbbbB+++++++++++++++++W
WWWWWWWWWWWWWWWWWWWWWWWWWWWWWWWWWWWWWWWWWWWWWWWWWWWWWWWWWWWWWWWWWWWWWWWWWWWWWWWWWWWWWWWWWWWWWWWWWWWWWWWWWWWWWWWWWWWWWWWWWWWWWWWWWW
