WWWWWWWWWWWWWWWWWWWWWWWWWWWWWWWWWWWWWWWWWWWWWWWWWWWWWWWWWWWWWWWWWWWWWWWWWWWWWWWWWWWWWWWWWWWWWWWWWWWWWWWWWWWWWWWWWWWWWWWWWWWWWWWWWW
W--WLevel2-----------------------------------------------------------------------------------------------------------------------W
W--------------------------------------------------------------------------------------------------------------------------------W
W--+-----------------------------------------------------------------------------------------------------------------------------W
W--------------------------------------------------------------------------------------------------------------------------------W
W--------------------------------------------------------------------------------------------------------------------------------W
W----------------------------------------------------W---------------------------------------------------------------------------W
W--------------------------------------------------------------------------------------------------------------------------------W
W--------------------------------------------------------------------------------------------------------------------------------W
W----------------------WWW-----------------------WWWWWWWWWW--WWWW----------------------------------------------------------------W
W---------------------W--W----------W---------------------------W----------------------------------------------------------------W
W--------------W-----W---W-------------------WW-WWWWWWWWWWW-----W----------------------------------------------------------------W
W--------------W----W----W--------W-----------------------W----------------------------------------------------------------------W
W--------------W-----------------W------WWW--+------------W----------------------------------------------------------------------W
W--------------W------------------------------++---++++++--------+---------------------------------------------------------------W
W--------------W-----------------------------WWW---WWWW--------W-----------------------------------------------------------------W
W-----------------------------W-----WW------W---------W-------W------------------------------------------------------------------W
W------------------W-WWWWWWW----------W----W-----------W-----W-------------------------------------------------------------------W
W--------------------------------------WWWW-------------W---W--------------------------------------------------------------------W
W------------------------------------------------WWWW----WWW---------------------------------------------------------------------W
W-------------------------------------------W-------W----------W-----------------------------------------------------------------W
W-------------------------------------------W------W--------W----WW-WW-W-WW-W-WWWWWWWW-WW----------------------------------------W
W--------------------------------------------W----W------------------------------------------------------------------------------W
W---------------------------------------------W--W-------------------------------------------------------------------------------W
WWWWWWWWWWWWWWWWWWWWWWWWWWWWWWWWWWWWWWWWWWWWWWWWWWWWWWWWWWWWWWWWWWWWWWWWWWWWWWWWWWWWWWWWWWWWWWWWWWWWWWWWWWWWWWWWWWWWWWWWWWWWWWWWWW
