WWWWWWWWWWWWWWWWWWWWWWWWWWWWWWWWWWWWWWWWWWWWWWWWWWWWWWWWWWWWWWWWWWWWWWWWWWWWWWWWWWWWWWWWWWWWWWWWWWWWWWWWWWWWWWWWWWWWWWWWWWWWWWWWWW
--+WLevel3-----------------------------------------------------------------------------------------------------------------------W
----WWWWW-WWWWWWWWWWWWWWWW-------------------------------------------------------------------------------------------------------W
---------W-------WWW------W------------------------------------------------------------------------------------------------------W
-W----WWW-W-----W---W------W----------------------------------+++++++++++--------------------------------------------------------W
W---WW-----W---W-----W-++---W--------------------------------+-----------+-------------------------------------------------------W
W----++++---W-WWWW----W--W---W------------++++++++++--------+-------------+------------------------------------------------------W
W----+---+---W-W--W--+-W------W----------+----------+------+---------------+-----------------------------------------------------W
W----+---+---WW+---W+---W--W-WW---------+------------+-----W----------------+----------------------------------------------------W
W+---+-++--++-WW+--+W----W-WW--W-------+--------------+--+--W---------------+----------------------------------------------------W
W-+-++-+-++--+-WW----W----WW----------+----------------++---W---WW---------+-----------------------------------------------------W
W----+--+----+--WW----W---WW----------+----------------+----------W-------+------------------------------------------------------W
W----++--+--+----WW----W-W-------------+---------------------------W-----+-------------------------------------------------------W
W----+-++-+++-----WWWWW-W---------------+---------------------------W---+--------------------------------------------------------W
W----+----+---------W--W-----------------+---------------------------W-+---------------------------------------------------------W
W----+---------------WW-------------------+--------------------------------------------------------------------------------------W
W------------------------------------------+-----------------------+-------------------------------------------------------------W
W-------------------------------------------++++++----------------+--------------------------------------------------------------W
W-------------------------------------------------++-------------+---------------------------------------------------------------W
W---------------------------------------------------+++---------+----------------------------------------------------------------W
W------------------------------------------------------+++++++++-----------------------------------------------------------------W
W--------------------------------------------------------------------------------------------------------------------------------W
W--------------------------------------------------------------------------------------------------------------------------------W
W--------------------------------------------------------------------------------------------------------------------------------W
WWWWWWWWWWWWWWWWWWWWWWWWWWWWWWWWWWWWWWWWWWWWWWWWWWWWWWWWWWWWWWWWWWWWWWWWWWWWWWWWWWWWWWWWWWWWWWWWWWWWWWWWWWWWWWWWWWWWWWWWWWWWWWWWWW
