WWWWWWWWWWWWWWWWWWWWWWWWWWWWWWWWWWWWWWWWWWWWWWWWWWWWWWWWWWWWWWWWWWWWWWWWWWWWWWWWWWWWWWWWWWWWWWWWWWWWWWWWWWWWWWWWWWWWWWWWWWWWWWWWWW
W--WLevel1--------------------------------W----------------------W---------------------------------------------------------------W
W----WWWWWWWWWWW---WWWW------------WWWWWWWWWWWWWWWWWWWWW----------W--------------WWWWWWWWWWW-------------------------------------W
W----W-------------W---W-----------W------W-------------W----------W-------------W---------W-------------------------------------W
W-------------+----WWWWW-----------W------WWWWWW---------W----------W-WWWWWWWWWWWW----WWWWW--------------------------------------W
W----W------++---------------------W------W----W----------W----------W----------------W------------------------------------------W
W----W--------+--WW---------WWWW-WWWWW----W----WWWWWW------W----W-----W---------------W------------------------------------------W
W----W------+--+---W--------W------W--W---W---------W-------W---W-++---W--------------W------------------------------------------W
W----W----------+---W-------W------W---W--WWWWWW---WW--------W--W---+---WW---+---WWWWWW------------------------------------------W
W----W----+++----+---W------WWWW---W----W------W-W--W---------W------+-----------------------------------------------------------W
W----W-------+----+---W--------W---W-----W-------W--WW--W--WW--W--+---W----+----WWW-WW--W----------------------------------------W
W----W--------+--+-----W--------WWWW------W------WW---------W---W--+--W+-----------+++-++++++-------W----------------------------W
W----WWWWWWWWW-++-------W------------------WWWWWWWW---------W----W--+-W-+-------W-+----------+------W----------------------------W
W------------W-++---WWW--W----------------------------------------W--+W--+-------+------------+----------------------------------W
W------------W-+-+--W-----WWWWWWWWWWWWWWWWWWWWWWWWW---WWW---W---------+---+-----+---+++++++++--+----W----------------------------W
W------------W--+++-W---------------------------------W-W--------------+---+-+++W---+-------+---+---W----------------------------W
W------------W------W--------------------------------WWWW----------W----+-----------+-------+--+----W----------------------------W
W------------W------WWWWWWWW--------------------------W-W--------W-W-----++++++++++++++++++++-+-----W----------------------------W
W----WWWWWWWWWWWWWWWW------W--------------------------W-W-------------------------WW-+-+++++++WWW-WWW----------------------------W
W--------W-------W---------WWWWWWWWWWWWWWWWWWWWWWWWWWWW-W-------------WWWWWWW---W-----+-----+------------------------------------W
W---------W-----W--------------W------------------------W-----------------------W------+---+-------------------------------------W
W----------W---W----------------W------------------W----WWWW--W--WWWWWWWWWWWWWWWW-------+++--------------------------------------W
W-----------WWW------------------WWW-----WWWW------W-----------------------------------------------------------------------------W
W--------------------------------------------W-----W-----------------------------------------------------------------------------W
WWWWWWWWWWWWWWWWWWWWWWWWWWWWWWWWWWWWWWWWWWWWWWWWWWWWWWWWWWWWWWWWWWWWWWWWWWWWWWWWWWWWWWWWWWWWWWWWWWWWWWWWWWWWWWWWWWWWWWWWWWWWWWWWWW
