WWWWWWWWWWWWWWWWWWWWWWWWWWWWWWWWWWWWWWWWWWWWWWWWWWWWWWWWWWWWWWWWWWWWWWWWWWWWWWWWWWWWWWWWWWWWWWWWWWWWWWWWWWWWWWWWWWWWWWWWWWWWWWWWWW
W--+---B-B--W----------W-----------------------W---------------------------------------------------------------------------------W
W-----B-B---DIIIIIIIIIKW-----------------------W---------------------------------------------------------------------------------W
WKœ----B-B--W----------W-----------------------W---------------------------------------------------------------------------------W
WWWWWWWWWWWWW----------W-----------------------W---------------------------------------------------------------------------------W
W----------W-----------W-----------------------W---------------------------------------------------------------------------------W
W----------W-----------W-----------------------W---------------------------------------------------------------------------------W
W----------W-----------W-----------------------W---------------------------------------------------------------------------------W
W----------WWWWWWDWWWWWWWWWWWWWWWWWWWWWWWWWWWWWW---------------------------------------------------------------------------------W
W-------------KW------------W-W--W-o-W-o-W--W------------------------------------------------------------------------------------W
W--------------W------------W-W--o-W-o-W-o--W------------------------------------------------------------------------------------W
W--------------W------------W-W-WWWWWWWWWWW-W------------------------------------------------------------------------------------W
WbbbbbbbbbbbbbbW------------D-W----------KW-W------------------------------------------------------------------------------------W
WbbbbbbbbbbbbbbW------------W-WWWWWWWWWWWWW-WWWWWWWWWWWWWWW----------------------------------------------------------------------W
WbbbbbbbbbbbbbbW------------W-----------------------------W----------------------------------------------------------------------W
WbbbbbbbbbbbbbbW------------WWWWWWWWWWWWWWWW--------------W----------------------------------------------------------------------W
WbbbbbbbbbbbbbbDo-----------W--------------W--------------W----------------------------------------------------------------------W
WbbbbbbbbbbbbbbW------------W--------------W--------------W----------------------------------------------------------------------W
WbbbbbbbbbbbbbbW---------œœœW--------------W--------------W----------------------------------------------------------------------W
WbbbbbbbbbbbbbbWWWWWWWWWWWWWW--------------D--------------W----------------------------------------------------------------------W
WbbbbbbbbbbbbbbW---------------------------W--------------W----------------------------------------------------------------------W
WbbbbbbbbbbbbbbW---------------------------W--------------W----------------------------------------------------------------------W
WbbbbbbbbbbbbbbW---------------------------W--------------W----------------------------------------------------------------------W
WbbbbbbbbbbbbbbW---------------------------W--------------D----------------------------------------------------------------------W
WWWWWWWWWWWWWWWWWWWWWWWWWWWWWWWWWWWWWWWWWWWWWWWWWWWWWWWWWWWWWWWWWWWWWWWWWWWWWWWWWWWWWWWWWWWWWWWWWWWWWWWWWWWWWWWWWWWWWWWWWWWWWWWWWW
