WWWWWWWWWWWWWWWWWWWWWWWWWWWWWWWWWWWWWWWWWWWWWWWWWWWWWWWWWWWWWWWWWWWWWWWWWWWWWWWWWWWWWWWWWWWWWWWWWWWWWWWWWWWWWWWWWWWWWWWWWWWWWWWWWW
W------+---------------------W-----W-----------------------W------WW---------------W--------WWWK-oo-------o---ooIII-bb---WK---xx-W
W----------------------------------W---WWWWWWWWWWW---W------------WW---------------W----------WWWWWWWWWWWWW-oIII---WWW---WWWWW--xW
WWWWWWWWW--W----------WWWWWWWW-----W-------------W---W-----W------WWWWWWWWWWWWWW---W-----oo---------------WIII-----W-W-------W---W
Wxx--x--W--WWWWWWW----W---W-----------WWWWWWWWWWWW--WWWWWWWW-------------------W------------oo-----W------WWWWWWbbWW-W-------Wxx-W
W-x----xW--W----------W---WWWWWWWWWWWWW------------------W----WWWWWWWW--------WWWWWWWWWWWWWo-WWW---W-x--xxW----------W---WWW-Wx--W
WIIWWWx-W--W----------W---------------xx----x---xxx------W----W---------------W--------------o-W---W-xx--xWWWWW------W---W-W----xW
WII-WWœKW--W----WWWWWWW---WWWWWWWWWW--x----x-------x-----WWWWWW-------------------WW--I--o-o-o-W---W-----x----W---W--WWWWW-W-W-x-W
WII-WWWWW--W----W---------W--------W--xx-WWWWWWWWWW------W-------WWWWWWWWWWWWWW----W-xx--WWWWWWWWWWW---xx-----W---W--W-----WWW---W
Wxx-W---WWWW----W------------------W-----W---------------W---W---WooIIIIII---------W-Ix--W--W--W--------------W---WWWW-----W---x-W
-xx-W---W------WW---------W--------W-----WWWWWWWWWWWWWWW-W---W---Woooo-œW----------W-Ixx-W--W--W---WWWWWWW-x--W---WWœW-W---W---x-W
W---W---W------W---WWWWWWWW--------W--WWWW---------W-----W---W---WWWWWWWW---WWWWWWWW-IIx-W--W-----WW-------x--W---WW-W-W---W---x-W
W---W---W---WWWW---W------------------W------------W-----WWWDW---WW---------W------------W--W-----W-----------W---WW---W-WWW-----W
W---W---W----------W---------WWWWW----W------WWWWWWW---------W---WW---------W-----WWWWWWWW--------W--WWWWWWWWWW---WW---W-W-W--W--W
W---W---WWWWWWWWWWWW---------W---W----W------W-----W---------W-------WWWWW--W------------WWWWW----W-------W-------WW-WWW-W-WWWW--W
W---b------------------WWWWWWW---W----W--WWWWW-xxx-W---------W-------W------WWWWWWWWWW------------W--xx--xW--------W-W---W-------W
W---W------------------W----o---oW----W----------x-WWWWWWWWWWWbbWWWWWW------W---------------------W--xx--xWWW------WWW--WW----oo-W
W---W------------------W--ooo----W----W------------WWWW-----oo-oooo--W---WWWW-----WWWWWWWWWW-WWWWWW----xx---W---WWWW-----W-----o-W
W---WWWWWWWWWWWWWWWWWWWW-------ooW----W---W---WWWWWWWWW--oo--o---oo--W---W--WWWWWWW----------------x-xxxx---W---W--------WWWW-oo-W
W----------bo---oo--oo--oo---o-o-WWWWWW---W---W--œœWWWWWWW-o--WWWWWWWW---W-------------------W--------------W---W--------W--W----W
W----------W-oooo--oooooo---------x-WWWWWWW---W----WWW--ooo-----ooW------W-------W---WWWWWWW-WWWWWWWWWWWWWWWW------------W--W---oW
W----------WWWWWWWWWWWWWWWWWW-x--x----xx---x--W----WWW-----oooooo-WWWWWWWWWWWWWWWW---------W----------------WWWWWWWWWWWWWW--W-oooW
WWWWWWWWWWWW----------------W--xxxx----xx--x-------WWWDWWWWWWWWWWWWWWWWWWW-----------------D-------------------------------------W
WK-oo--xxxxxIIIIIII-----------x------WWWWWWWWWWWWWWWWW---xx--xxx-+WWWWWWWW-----------------W--------------------------------W----W
WWWWWWWWWWWWWWWWWWWWWWWWWWWWWWWWWWWWWWWWWWWWWWWWWWWWWWWWWWWWWWWWWWWWWWWWWWWWWWWWWWWWWWWWWWWWWWWWWWWWWWWWWWWWWWWWWWWWWWWWWWWWWWWWWW
