WWWWWWWWWWWWWWWWWWWWWWWWWWWWWWWWWWWWWWWWWWWWWWWWWWWWWWWWWWWWWWWWWWWWWWWWWWWWWWWWWWWWWWWWWWWWWWWWWWWWWWWWWWWWWWWWWWWWWWWWWWWWWWWWWW
W--level_3----------------------------------------------------------------------------------WWW----------------------------------W
W-----+---------------------------------------------------------------------------------------WWWWWWWWWWWWWWW--------------------W
WWWWWWWWW--------------WWW--------------------------------------------------------------------------------W----------------------W
W-------W-------------W---W-------------------------------------------------------------------------------W----------------------W
W-------W-------------W---W---------------------------------------------------WWWWWWWWWWWWWWWW---W--------W----------------------W
W--WWW--W-------------W---W---------------------------------------------------W---------------W--W---------WWWW------------------W
W----W--W-------WWWWWW----W---------------------------------------------------W---WW-----------W-W-WWW--------W------------------W
W----WWWW-------W---------W---------------WWWWW------------------WWWWWWWWWWWWWW----W------WWWWWWWWWW----------W------------------W
W-------W-------W---------W--------------W-----------------------W-----------------W-----W-----W--------------W------------------W
W---W---WWWWWWWWW---------W--------------W-----------------------W-----------------W-----W-----W---WWWWWWW----W------------------W
W---W--------------WWWWWWWW------------WWW-----------------------W----------WWWWWWW------W-----W--W-----------W------------------W
W---W--------------W---------W--------W--------------------------W----------W------------W-----W--W---------WWW------------------W
W---W--------------W---------WWWW-----W------WWWWWW---------------WW--------W-----WWWWWWW------W--W--WWWWWWWWWW------------------W
W---W---WWWWWWWWWWW----------W---W----W------W-----W------------------------W---------------------W-------W----------------------W
W---W------------------WWWWWWW---W----W-WWWWW------W-----------------W------W-----------------------------W----------------------W
W---W------------------W---------W----W------------W-----------------W------W---------------------W-------WWW--------------------W
W---W------------------W---------W----W------------W-----------------W------W------WWWWWWWWWWWWWWW----------W--------------------W
W----WWWWWWWWWWWWWWWWWW----------W----W--------WWWWW-----------------W------W-----W-------------------------W--------------------W
W---------------------------------WWWWW-------W------WWWWWWWWWWWWWWWWW-------WWWWWW----------W--------------W--------------------W
W---------------------------------------------W------W-------------------------------WWWW----WWWWWWWWWWWWWWW---------------------W
W---------------------------------------------W------W---------------------------------------------------------------------------W
W---------------------------------------------WWWWWWW----------------------------------------------------------------------------W
W--------------------------------------------------------------------------------------------------------------------------------W
WWWWWWWWWWWWWWWWWWWWWWWWWWWWWWWWWWWWWWWWWWWWWWWWWWWWWWWWWWWWWWWWWWWWWWWWWWWWWWWWWWWWWWWWWWWWWWWWWWWWWWWWWWWWWWWWWWWWWWWWWWWWWWWWWW
