WWWWWWWWWWWWWWWWWWWWWWWWWWWWWWWWWWWWWWWWWWWWWWWWWWWWWWWWWWWWWWWWWWWWWWWWWWWWWWWWWWWWWWWWWWWWWWWWWWWWWWWWWWWWWWWWWWWWWWWWWWWWWWWWWW
W-+WLevel1-----------------------------------------------------------------------------------------------------------------------W
W-WW--------------W--------------------------------------------------------------------------------------------------------------W
W-K---WWWW--WW--DD--------------B--------B---------------------------------------------------------------------------------------W
W----W--------W------------------------------------------------------------------------------------------------------------------W
W----W--+---+------D-------------------------------------------------------------------------------------------------------------W
W--------------W-----------------------WW----++------W---------------------------------------------------------------------------W
W----W--W-W-W--W--W---WW-WW-W--WWWWWWWWWWW---------------------------------------------------------------------------------------W
WWWWWWWWWWWWW-----------------------------W--------------------------------------------------------------------------------------W
W---D-------W----------WWW-----------------W-----WWWWWWWWWW--WWWW----------------------------------------------------------------W
W-----------W---------W--W----------W-----+-W-------------------W----------------------------------------------------------------W
W-----------W--W-----W---W-----------------+-WWWWWWWWWWWWWW-----W----------------------------------------------------------------W
W-----------W--W----W----W--------W---------+-------------W----------------------------------------------------------------------W
W----+------W--W-----------------W------WWW--+------------W----------------------------------------------------------------------W
W-----------W--W------------------------------++---++++++--------+---------------------------------------------------------------W
W-----------W--W-----------------------------WWW---WWWW--------W-----------------------------------------------------------------W
W-----------W-----------------W-----WW------W---------W-------W------------------------------------------------------------------W
WWDWWWWWWWWDW------W-WWWWWWW----------W----W-----------W-----W-------------------------------------------------------------------W
W-----------W--------------------------WWWW-------------W---W--------------------------------------------------------------------W
W-BBBBBBBBB-W------------------------------------WWWW----WWW---------------------------------------------------------------------W
W--B-----B--W-------------------------------W-------W----------W-----------------------------------------------------------------W
W-B--BBB--B-W-------------------------------W------W--------W----WW-WW-W-WW-W-WWWWWWWW-WW----------------------------------------W
WB-B-----B-BW--------------------------------W----W------------------------------------------------------------------------------W
W----BBB----D---------------------------------W--W-------------------------------------------------------------------------------W
WWWWWWWWWWWWWWWWWWWWWWWWWWWWWWWWWWWWWWWWWWWWWWWWWWWWWWWWWWWWWWWWWWWWWWWWWWWWWWWWWWWWWWWWWWWWWWWWWWWWWWWWWWWWWWWWWWWWWWWWWWWWWWWWWW
