WWWWWWWWWWWWWWWWWWWWWWWWWWWWWWWWWWWWWWWWWWWWWWWWWWWWWWWWWWWWWWWWWWWWWWWWWWWWWWWWWWWWWWWWWWWWWWWWWWWWWWWWWWWWWWWWWWWWWWWWWWWWWWWWWW
W--WLevel3-----------------------------------------------------------------------------------------------------------------------W
W-WWWWWWW-WWWWWWWWWWWWWWWW-------------------------------------------------------------------------------------------------------W
WW-------W-------WWW------W------------------------------------------------------------------------------------------------------W
WW-+--WWW-W-----W---W------W----------------------------------+++++++++++--------------------------------------------------------W
WWWWWW-----W---W-----W-++---W--------------------------------+-----------+-------------------------------------------------------W
W----++++---W-WWWW----W--W---W------------++++++++++--------+-------------+------------------------------------------------------W
W----+---+---W-W--W--+-W------W----------+----------+------+---------------+-----------------------------------------------------W
W----+---+---WW+---W+---W--W-WW---------+------------+----+-----------------+----------------------------------------------------W
W+---+-++--++-WW+--+W----W-WW--W-------+--------------+--+------------------+----------------------------------------------------W
W-+-++-+-++--+-WW----W----WW----------+----------------++------------------+-----------------------------------------------------W
W----+--+----+--WW----W---WW----------+----------------+------------------+------------------------------------------------------W
W----++--+--+----WW----W-W-------------+---------------------------------+-------------------------------------------------------W
W----+-++-+++-----WWWWW-W---------------+-------------------------------+--------------------------------------------------------W
W----+----+---------W--W-----------------+-----------------------------+---------------------------------------------------------W
W----+---------------WW-------------------+-------------------------+++----------------------------------------------------------W
W------------------------------------------+-----------------------+-------------------------------------------------------------W
W-------------------------------------------++++++----------------+--------------------------------------------------------------W
W-------------------------------------------------++-------------+---------------------------------------------------------------W
W---------------------------------------------------+++---------+----------------------------------------------------------------W
W------------------------------------------------------+++++++++-----------------------------------------------------------------W
W--------------------------------------------------------------------------------------------------------------------------------W
W--------------------------------------------------------------------------------------------------------------------------------W
W--------------------------------------------------------------------------------------------------------------------------------W
WWWWWWWWWWWWWWWWWWWWWWWWWWWWWWWWWWWWWWWWWWWWWWWWWWWWWWWWWWWWWWWWWWWWWWWWWWWWWWWWWWWWWWWWWWWWWWWWWWWWWWWWWWWWWWWWWWWWWWWWWWWWWWWWWW
