WWWWWWWWWWWWWWWWWWWWWWWWWWWWWWWWWWWWWWWWWWWWWWWWWWWWWWWWWWWWWWWWWWWWWWWWWWWWWWWWWWWWWWWWWWWWWWWWWWWWWWWWWWWWWWWWWWWWWWWWWWWWWWWWWW
W--CLevel1-------------------------------------------------------------------------------W++++++++++++++++W----------------------W
W----------------------------------------------------------------------------------------W++++++++++++++++W----------------------W
W----------------------------------------------------------------------------------------W++++++++++++++++W----------------------W
W----------------------------------------------------------------------------------------d++++++++++++++++W----------------------W
W----------------------------------------------------------------------------------------W++++++++++++++++W----------------------W
W----------------------------------------------------------------------------------------W++++++++++++++++W----------------------W
W----------------------------------------------------------------------------------------WWWWWWWWWDWWWWWWWW----------------------W
W-------------------------------------------------------------------------------------------------k------------------------------W
W--------------------------------------------------------------------------------------------------------------------------------W
W--------------------------------------------------------------------------------------------------------------------------------W
W---------------------K----------------------------------------------------------------------------------------------------------W
W--------------------------------------------------------------------------------------------------------------------------------W
W--------------------------------------------------------------------------------------------------------------------------------W
W--------------------------------------------------------------------------------------------------------------------------------W
W--------------------------------------------------------------------------------------------------------------------------------W
W--------------------------------------------------------------------------------------------------------------------------------W
W--------------------------------------------------------------------------------------------------------------------------------W
W--------------------------------------------------------------------------------------------------------------------------------W
W--------------------------------------------------------------------------------------------------------------------------------W
W--------------------------------------------------------------------------------------------------------------------------------W
W--------------------------------------------------------------------------------------------------------------------------------W
W--------------------------------------------------------------------------------------------------------------------------------W
W--------------------------------------------------------------------------------------------------------------------------------W
WWWWWWWWWWWWWWWWWWWWWWWWWWWWWWWWWWWWWWWWWWWWWWWWWWWWWWWWWWWWWWWWWWWWWWWWWWWWWWWWWWWWWWWWWWWWWWWWWWWWWWWWWWWWWWWWWWWWWWWWWWWWWWWWWW
