WWWWWWWWWWWWWWWWWWWWWWWWWWWWWWWWWWWWWWWWWWWWWWWWWWWWWWWWWWWWWWWWWWWWWWWWWWWWWWWWWWWWWWWWWWWWWWWWWWWWWWWWWWWWWWWWWWWWWWWWWWWWWWWWWW
W--CLevel1-------------------------------------------------------------------------------W++++++++++++++++W----------------------W
W----------------------------------------------------------------------------------------W++++++++++++++++W----------------------W
W----------------------------------------------------------------------------------------W++++++++++++++++W----------------------W
W----------------------------------------------------------------------------------------W++++++++++++++++W----------------------W
W----------------------------------------------------------------------------------------W++++++++++++++++W----------------------W
W----------------+-----------------------------------------------------D-----------------W++++++++++++++++W----------------------W
W-----------------------------------------------------DD---------------------------------WWWWWWWWWDWWWWWWWW----------------------W
W--------------------------------------------------------------------------------------------------------------------------------W
W--------------------------------------------------------------------------D-----------------------------------------------------W
W-----------------------------------------------------D--------------------------------------------------------------------------W
W---------------------K-BB-------------------------------------------------------------------------------------------------------W
W--------------------------------------------------------------------------------------------------------------------------------W
W--------------------------------------------------------------------------------------------------------------------------------W
W--------------------------------------------------------------------------------------------------------------------------------W
W--------------------------------------------------------------------------------------------------------------------------------W
W--------------------------------------------------------------------------------------------------------------------------------W
W--------------------------------------------------------------------------------------------------------------------------------W
W--------------------------------------------------------------------------------------------------------------------------------W
W--------------------------------------------------------------------------------------------------------------------------------W
W--------------------------------------------------------------------------------------------------------------------------------W
W--------------------------------------------------------------------------------------------------------------------------------W
W--------------------------------------------------------------------------------------------------------------------------------W
W--------------------------------------------------------------------------------------------------------------------------------W
WWWWWWWWWWWWWWWWWWWWWWWWWWWWWWWWWWWWWWWWWWWWWWWWWWWWWWWWWWWWWWWWWWWWWWWWWWWWWWWWWWWWWWWWWWWWWWWWWWWWWWWWWWWWWWWWWWWWWWWWWWWWWWWWWW
